bures	ˈburɛs
výtvoru	ˈviːtvɔru
vrazd	ˈvrazd
zastrel	ˈzastrɛl
vady	ˈvadi
vyplaz	ˈviplaz
pľujem	ˈpʎujɛm
kanom	ˈkanɔm
savka	ˈsavka
dop	ˈdɔp
slaboch	ˈsɫabɔx
kvete	ˈkvɛtɛ
ľavej	ˈʎavɛj
svojímm	ˈsvɔjiːm
pajama	ˈpajama
stropným	ˈstrɔpniːm
zľaní	ˈzʎaɲiː
serveru	ˈsɛrvɛru
komunít	ˈkɔmuniːt
skromných	ˈskrɔmniːx
vleku	ˈvɫɛku
božskom	ˈbɔʒskɔm
skapeš	ˈskapɛʃ
podvod	ˈpɔdvɔd
vykonat	ˈvikɔnat
zebrý	ˈzɛbriː
sušený	ˈsuʃɛniː
dobredu	ˈdɔbrɛdu
drake	ˈdrakɛ
zombí	ˈzɔmbiː
pokosíš	ˈpɔkɔsiːʃ
bedlam	ˈbɛdɫam
jor	ˈjɔr
mužstvo	ˈmuʒstvɔ
camo	ˈtsamɔ
domer	ˈdɔmɛr
batou	ˈbatɔu
smuš	ˈsmuʃ
care	ˈtsarɛ
napíš	ˈnapiːʃ
some	ˈsɔmɛ
vrstvým	ˈvrstviːm
pestu	ˈpɛstu
poslaný	ˈpɔsɫaniː
dasn	ˈdasn
slza	ˈsɫza
drujej	ˈdrujɛj
caren	ˈtsarɛn
vrtným	ˈvrtniːm
spozna	ˈspɔzna
balíka	ˈbaɫiːka
sent	ˈsɛnt
poms	ˈpɔms
bosa	ˈbɔsa
kamenka	ˈkamɛnka
povaľuje	ˈpɔvaʎujɛ
výjeb	ˈviːjɛb
zľavu	ˈzʎavu
kahna	ˈkaɦna
benom	ˈbɛnɔm
výdaje	ˈviːdajɛ
soška	ˈsɔʃka
skol	ˈskɔɫ
veľmý	ˈvɛʎmiː
zbere	ˈzbɛrɛ
basu	ˈbasu
pozrý	ˈpɔzriː
tepny	ˈtɛpni
pojed	ˈpɔjɛd
vymeníš	ˈvimɛniːʃ
svojským	ˈsvɔjskiːm
stredovej	ˈstrɛdɔvɛj
štvorec	ˈʃtvɔrɛt
kolač	ˈkɔɫat
vyplakala	ˈviplaka
slabneš	ˈsɫabɲɛʃ
stomp	ˈstɔmp
výdaja	ˈviːdaja
zvuku	ˈzvuku
strehu	ˈstrɛhu
spodkom	ˈspɔdkɔm
jp	ˈjp
dok	ˈdɔk
zapína	ˈzapiːna
carp	ˈtsarp
dope	ˈdɔpɛ
über	ˈbɛr
dojmu	ˈdɔjmu
stuka	ˈstuka
zručných	ˈzrutʃniːx
tají	ˈtajiː
ľode	ˈʎɔɟɛ
dostam	ˈdɔstɑm
čast	ˈtʃast
šekom	ˈʃɛkɔm
zohnal	ˈzɔɦnal
troj	ˈtrɔj
strokes	ˈstrɔkɛs
voly	ˈvɔli
vrav	ˈvrav
zmetka	ˈzmɛtka
stejky	ˈstɛjki
kost	ˈkɔst
jasna	ˈjasna
kremu	ˈkrɛmu
dzus	ˈdzus
peeka	ˈpɛka
dotykal	ˈdɔtikal
kokona	ˈkɔna
stupen	ˈstupɛn
zruš	ˈzruʃ
rodových	ˈrɔdɔviːx
spadne	ˈspadɲɛ
slova	ˈsɫɔva
son	ˈsɔn
zvanom	ˈzvanɔm
saru	ˈsaru
keš	ˈkɛʃ
což	ˈtsɔʒ
kvantum	ˈkvantum
slamke	ˈsɫamkɛ
topím	ˈtɔpiːm
kozme	ˈkɔzmɛ
zakryjem	ˈzakrijɛm
paule	ˈpaulɛ
zapatu	ˈzapatu
beesa	ˈbɛsa
soner	ˈsɔnɛr
cru	ˈtsru
skrate	ˈskratɛ
comera	ˈtsɔmɛra
mucho	ˈmuxɔ
zvýš	ˈzviːʃ
zostrelí	ˈzɔstrɛliː
zoho	ˈzɔɦɔ
padne	ˈpadɲɛ
sadím	ˈsadiːm
kamose	ˈkamɔsɛ
spotené	ˈspɔtɛnɛː
sladíš	ˈsɫadiːʃ
vrach	ˈvrax
zalej	ˈzalɛj
štvrej	ˈʃtvrɛj
zenu	ˈzɛnu
pornos	ˈpɔrnɔs
kecy	ˈkɛtsi
slamy	ˈsɫami
kramom	ˈkramɔm
stavaný	ˈstavaniː
tejl	ˈtɛjl
vlákna	ˈvɫaːkna
kravu	ˈkravu
konto	ˈkɔntɔ
varu	ˈvaru
vrakom	ˈvrakɔm
neštve	ˈɲɛʃtvɛ
pasujem	ˈpasujɛm
doprav	ˈdɔprav
vendu	ˈvɛndu
tupým	ˈtupiːm
vozle	ˈvɔzɫɛ
saber	ˈsabɛr
cej	ˈtsɛj
týma	ˈtiːma
kadaj	ˈkadaj
skort	ˈskɔrt
slovný	ˈsɫɔvniː
markove	ˈmarkɔvɛ
koh	ˈkɔɦ
vím	ˈviːm
slava	ˈsɫava
svojku	ˈsvɔjku
poleje	ˈpɔlɛjɛ
zarež	ˈzarɛʒ
svätu	ˈsvɛtu
voj	ˈvɔj
pokojných	ˈpɔkɔjniːx
tana	ˈtana
sporov	ˈspɔrɔv
dvesto	ˈdvɛstɔ
zrely	ˈzrɛli
neera	ˈɲɛra
bazeny	ˈbazɛni
sprej	ˈsprɛj
krajoch	ˈkrajɔx
sve	ˈsvɛ
soze	ˈsɔzɛ
hops	ˈɦɔps
pojebný	ˈpɔjɛbniː
zamoruje	ˈzamɔrujɛ
zmučený	ˈzmutʃɛniː
člun	ˈtʃɫun
vyhov	ˈvihɔv
verným	ˈvɛrniːm
vlkov	ˈvɫkɔv
dobrel	ˈdɔbrɛl
konov	ˈkɔnɔv
vypol	ˈvipɔl
svok	ˈsvɔk
jmz	ˈjmz
konal	ˈkɔnal
dazda	ˈdazda
paska	ˈpaska
posekal	ˈpɔsɛkal
soľný	ˈsɔʎniː
klenote	ˈklɛnɔtɛ
struka	ˈstruka
zvery	ˈzvɛri
zawr	ˈzar
zobáka	ˈzɔbaːka
výhodný	ˈviːhɔdniː
kave	ˈkavɛ
padnete	ˈpadɲɛtɛ
štve	ˈʃtvɛ
struny	ˈstruni
thom	ˈtɦɔm
strankam	ˈstrankam
stavíš	ˈstaviːʃ
pokos	ˈpɔkɔs
zovu	ˈzɔvu
vláda	ˈvɫaːda
kurací	ˈkuratsiː
ježa	ˈjɛʒa
kote	ˈkɔtɛ
šom	ˈʃɔm
šejk	ˈʃɛjk
krva	ˈkrva
mosí	ˈmɔsiː
sladovej	ˈsɫadɔvɛj
horských	ˈɦɔrskiːx
hps	ˈɦps
hrbe	ˈɦrbɛ
patel	ˈpatɛl
zaber	ˈzabɛr
drana	ˈdrana
voš	ˈvɔʃ
frajerky	ˈfrajɛrki
zmluvu	ˈzmɫuvu
čaka	ˈtʃaka
sebov	ˈsɛbɔv
dovolí	ˈdɔvɔliː
vepra	ˈvɛpra
vladne	ˈvɫadɲɛ
budume	ˈbudumɛ
povedome	ˈpɔvɛdɔmɛ
kupat	ˈkupat
kazu	ˈkazu
tajnu	ˈtajnu
tedy	ˈtɛdi
nedo	ˈɲɛdɔ
pestujem	ˈpɛstujɛm
baum	ˈbaum
baku	ˈbaku
tvej	ˈtvɛj
čaje	ˈtʃajɛ
tome	ˈtɔmɛ
kruchov	ˈkruxɔv
vetko	ˈvɛtkɔ
daba	ˈdaba
balíš	ˈbaɫiːʃ
vedy	ˈvɛdi
vasmu	ˈvasmu
častým	ˈtʃastiːm
komenko	ˈkɔmɛnkɔ
zapojí	ˈzapɔjiː
pamet	ˈpamɛt
hodný	ˈɦɔdniː
pastu	ˈpastu
jalových	ˈjalɔviːx
mojoj	ˈmɔjɔj
suna	ˈsuna
depka	ˈdɛpka
savu	ˈsavu
hrdým	ˈɦrdiːm
katu	ˈkatu
james	ˈjamɛs
homer	ˈɦɔmɛr
naraný	ˈnaraniː
hosta	ˈɦɔsta
vychodne	ˈvixɔdɲɛ
zjest	ˈzjɛst
zvučí	ˈzvutʃiː
pas	ˈpas
dvojaký	ˈdvɔjakiː
jase	ˈjasɛ
kotla	ˈkɔtɫa
posedte	ˈpɔsɛdtɛ
dojo	ˈdɔjɔ
celou	ˈtsɛlɔu
zastrelý	ˈzastrɛliː
vej	ˈvɛj
drs	ˈdrs
dacha	ˈdaxa
menovka	ˈmɛnɔvka
zavesu	ˈzavɛsu
zvolaný	ˈzvɔlɑniː
vrada	ˈvrada
vespa	ˈvɛspa
splav	ˈspɫav
moskve	ˈmɔskvɛ
kondo	ˈkɔndɔ
hame	ˈɦamɛ
hoos	ˈɦɔs
vyhreš	ˈvihrɛʃ
bojo	ˈbɔjɔ
konare	ˈkɔnarɛ
sonaru	ˈsɔnaru
dresov	ˈdrɛsɔv
stran	ˈstran
svrab	ˈsvrab
splatný	ˈspɫatniː
pojítko	ˈpɔjiːtkɔ
soa	ˈsɔa
dospej	ˈdɔspɛj
vresk	ˈvrɛsk
zornom	ˈzɔrnɔm
zmej	ˈzmɛj
zvezok	ˈzvɛzɔk
sambu	ˈsambu
pozreme	ˈpɔzrɛmɛ
poznas	ˈpɔznas
výjs	ˈviːjs
skara	ˈskara
col	ˈtsɔɫ
vyplaš	ˈviplaʃ
slnku	ˈsɫnku
juzny	ˈjuzni
zlatík	ˈzɫatiːk
zapomeň	ˈzapɔmɛɲ
žujem	ˈʒujɛm
bena	ˈbɛna
zabudne	ˈzabudɲɛ
svetý	ˈsvɛtiː
balon	ˈbaɫɔn
strunou	ˈstrunɔu
zaprel	ˈzaprɛl
keth	ˈkɛtɦ
možný	ˈmɔʒniː
skore	ˈskɔrɛ
kupole	ˈkupɔlɛ
dod	ˈdɔd
sprejov	ˈsprɛjɔv
mokre	ˈmɔkrɛ
zda	ˈzda
cor	ˈtsɔr
poláska	ˈpɔɫaːska
vosku	ˈvɔsku
kempe	ˈkɛmpɛ
keds	ˈkɛds
bankov	ˈbankɔv
save	ˈsavɛ
stku	ˈstku
srna	ˈsrna
jarom	ˈjarɔm
skromným	ˈskrɔmniːm
moda	ˈmɔda
koove	ˈkɔvɛ
dokonalí	ˈdɔkɔnaliː
spravný	ˈspravniː
careca	ˈtsarɛtsa
kolec	ˈkɔlɛt
pozveš	ˈpɔzvɛʃ
kant	ˈkant
bazenova	ˈbazɛnɔva
morave	ˈmɔravɛ
sprave	ˈspravɛ
homera	ˈɦɔmɛra
cholere	ˈxɔlɛrɛ
sudov	ˈsudɔv
povest	ˈpɔvɛst
zaskočí	ˈzaskɔtʃiː
jaws	ˈjas
moho	ˈmɔɦɔ
dokoch	ˈdɔkɔx
vypšal	ˈvipʃal
výstupným	ˈviːstupniːm
našemu	ˈnaʃɛmu
neel	ˈɲɛl
tojí	ˈtɔjiː
beda	ˈbɛda
zobert	ˈzɔbɛrt
coru	ˈtsɔru
vlnku	ˈvɫnku
zostupu	ˈzɔstupu
joho	ˈjɔɦɔ
dusí	ˈdusiː
močku	ˈmɔtʃku
jolo	ˈjɔɫɔ
sofer	ˈsɔfɛr
dojato	ˈdɔjatɔ
sore	ˈsɔrɛ
handu	ˈɦandu
vece	ˈvɛtsɛ
vybornu	ˈvibɔrnu
doletí	ˈdɔlɛtiː
jemo	ˈjɛmɔ
čb	ˈtʃb
krve	ˈkrvɛ
skvrnu	ˈskvrnu
zdroje	ˈzdrɔjɛ
pokuse	ˈpɔkusɛ
postraším	ˈpɔstraʃiːm
šepkaných	ˈʃɛpkaniːx
vým	ˈviːm
samba	ˈsamba
struku	ˈstruku
voce	ˈvɔtsɛ
zvyskom	ˈzviskɔm
zapadnej	ˈzapadɲɛj
zlatých	ˈzɫatiːx
tlamou	ˈtɫamɔu
poznamenat	ˈpɔznamɛnat
sporím	ˈspɔriːm
potrela	ˈpɔtrɛlɑ
pantík	ˈpantiːk
vysadím	ˈvisadiːm
poco	ˈpɔtsɔ
pohodu	ˈpɔɦɔdu
zaser	ˈzasɛr
backa	ˈbatska
zadusím	ˈzadusiːm
jasom	ˈjasɔm
horár	ˈɦɔraːr
jest	ˈjɛst
bazenoch	ˈbazɛnɔx
dum	ˈdum
sporíš	ˈspɔriːʃ
sladku	ˈsɫadku
stopro	ˈstɔprɔ
dre	ˈdrɛ
predobedom	ˈprɛdɔbɛdɔm
varov	ˈvarɔv
pastí	ˈpastiː
torum	ˈtɔrum
sloba	ˈsɫɔba
namočí	ˈnamɔtʃiː
zmarený	ˈzmarɛniː
käthe	ˈkɛtɦɛ
vrave	ˈvravɛ
stranku	ˈstranku
kroner	ˈkrɔnɛr
vyhrajem	ˈvihrajɛm
slobo	ˈsɫɔbɔ
blade	ˈbladɛ
poštím	ˈpɔʃtiːm
cob	ˈtsɔb
semo	ˈsɛmɔ
tumom	ˈtumɔm
zpívat	ˈzpiːvat
baste	ˈbastɛ
vežkým	ˈvɛʒkiːm
skreč	ˈskrɛt
výmenou	ˈviːmɛnɔu
sladovku	ˈsɫadɔvku
zmoze	ˈzmɔzɛ
tamova	ˈtamɔva
vyhram	ˈvihram
cára	ˈtsaːra
zvalím	ˈzvaliːm
pokusná	ˈpɔkusnaː
krvná	ˈkrvnaː
vojska	ˈvɔjska
streep	ˈstrɛp
zvleč	ˈzvlɛt
vode	ˈvɔɟɛ
bacha	ˈbaxa
skej	ˈskɛj
ztrata	ˈztrata
doja	ˈdɔja
sate	ˈsatɛ
sver	ˈsvɛr
cm	ˈtsm
dov	ˈdɔv
karte	ˈkartɛ
spam	ˈspam
varujem	ˈvarujɛm
trupe	ˈtrupɛ
čus	ˈtʃus
mozny	ˈmɔzni
tavíme	ˈtaviːmɛ
pokryje	ˈpɔkrijɛ
spojí	ˈspɔjiː
ceckov	ˈtsɛtskɔv
zabodne	ˈzabɔdɲɛ
horným	ˈɦɔrniːm
soláru	ˈsɔɫaːru
stomu	ˈstɔmu
šekov	ˈʃɛkɔv
odna	ˈɔdna
coredo	ˈtsɔrɛdɔ
deba	ˈdɛba
volení	ˈvɔlɛniː
tos	ˈtɔs
zakona	ˈzakɔna
pea	ˈpɛa
močom	ˈmɔtʃɔm
speve	ˈspɛvɛ
posunkov	ˈpɔsunkɔv
žeee	ˈʒɛɛ
samu	ˈsamu
plaza	ˈpɫaza
tepu	ˈtɛpu
morí	ˈmɔriː
buša	ˈbuʃa
keˇm	ˈkɛm
zodrat	ˈzɔdrat
trendy	ˈtrɛndi
slovu	ˈsɫɔvu
kreme	ˈkrɛmɛ
šerých	ˈʃɛriːx
potíme	ˈpɔtiːmɛ
polej	ˈpɔlɛj
cola	ˈtsɔɫa
haram	ˈɦaram
bolestou	ˈbɔlɛstɔu
tomato	ˈtɔmatɔ
drze	ˈdrzɛ
zosta	ˈzɔstɑ
bamu	ˈbamu
tone	ˈtɔnɛ
poškaj	ˈpɔʃkaj
kupredu	ˈkuprɛdu
čen	ˈtʃɛn
zata	ˈzata
dravých	ˈdraviːx
poznají	ˈpɔznajiː
kostný	ˈkɔstniː
pása	ˈpaːsa
cool	ˈtsɔɫ
troju	ˈtrɔju
ježíš	ˈjɛʒiːʃ
čr	ˈtʃ
výdrž	ˈviːdrʒ
bete	ˈbɛtɛ
stav	ˈstav
voja	ˈvɔja
splní	ˈspɫɲiː
zbate	ˈzbatɛ
dba	ˈdba
jupí	ˈjupiː
ktrých	ˈktriːx
zajet	ˈzajɛt
upec	ˈupɛt
dojemný	ˈdɔjɛmniː
vojakom	ˈvɔjakɔm
sek	ˈsɛk
kapustu	ˈkapustu
stupol	ˈstupɔɫ
spre	ˈsprɛ
namocí	ˈnamɔtsiː
marových	ˈmarɔviːx
svrabe	ˈsvrabɛ
cark	ˈtsark
jarou	ˈjarɔu
hamba	ˈɦamba
każdý	ˈkadiː
hama	ˈɦama
zlož	ˈzɫɔʒ
tus	ˈtus
doreka	ˈdɔrɛka
dabuje	ˈdabujɛ
zdarec	ˈzdarɛt
vanok	ˈvanɔk
kbe	ˈkbɛ
wou	ˈɔu
bandou	ˈbandɔu
dosku	ˈdɔsku
card	ˈtsard
kadím	ˈkadiːm
boros	ˈbɔrɔs
sorač	ˈsɔrat
wha	ˈɦa
domas	ˈdɔmas
vysaj	ˈvisaj
pasuje	ˈpasujɛ
vauu	ˈvau
tlamy	ˈtɫami
sado	ˈsadɔ
dosere	ˈdɔsɛrɛ
šeková	ˈʃɛkɔvɑː
cku	ˈtsku
vezu	ˈvɛzu
seno	ˈsɛnɔ
vojenskí	ˈvɔjɛnskiː
toa	ˈtɔa
jamu	ˈjamu
strelou	ˈstrɛlɔu
bezp	ˈbɛzp
kesty	ˈkɛsti
dopísal	ˈdɔpiːsal
kokosových	ˈkɔsɔviːx
dobru	ˈdɔbru
znamu	ˈznamu
nezu	ˈɲɛzu
sona	ˈsɔna
vecou	ˈvɛtsɔu
kutím	ˈkutiːm
volaju	ˈvɔlɑju
zotaneš	ˈzɔtaɲɛʃ
tous	ˈtɔus
zarazený	ˈzarazɛniː
coral	ˈtsɔral
vate	ˈvatɛ
vojem	ˈvɔjɛm
jesto	ˈjɛstɔ
tajov	ˈtajɔv
varenom	ˈvarɛnɔm
mužnou	ˈmuʒnɔu
plast	ˈpɫast
spol	ˈspɔɫ
toru	ˈtɔru
dvom	ˈdvɔm
karesom	ˈkarɛsɔm
strešnom	ˈstrɛʃnɔm
draba	ˈdraba
polat	ˈpɔɫat
zrnka	ˈzrnka
zkratku	ˈzkratku
tukových	ˈtukɔviːx
zbadaný	ˈzbadaniː
podusíme	ˈpɔdusiːmɛ
jaruš	ˈjaruʃ
zhoz	ˈzhɔz
sabres	ˈsabrɛs
spock	ˈspɔts
smrdý	ˈsmrdiː
postavaný	ˈpɔstavaniː
vyhras	ˈvihras
mosadu	ˈmɔsadu
zaskoč	ˈzaskɔt
kras	ˈkras
domenkov	ˈdɔmɛnkɔv
skopem	ˈskɔpɛm
zobu	ˈzɔbu
zotaví	ˈzɔtaviː
moruše	ˈmɔruʃɛ
výdaj	ˈviːdaj
troma	ˈtrɔma
tramp	ˈtramp
krave	ˈkravɛ
slabom	ˈsɫabɔm
slona	ˈsɫɔna
zaboduje	ˈzabɔdujɛ
koralový	ˈkɔralɔviː
kastu	ˈkastu
doho	ˈdɔɦɔ
zdat	ˈzdat
duck	ˈduts
hadku	ˈɦadku
potím	ˈpɔtiːm
moseho	ˈmɔsɛhɔ
stvorení	ˈstvɔrɛniː
vratký	ˈvratkiː
becka	ˈbɛtska
cemo	ˈtsɛmɔ
vypoved	ˈvipɔvɛd
dlabem	ˈdɫabɛm
zamočí	ˈzamɔtʃiː
sendak	ˈsɛndak
zodve	ˈzɔdvɛ
zadkoch	ˈzadkɔx
beka	ˈbɛka
ktore	ˈktɔrɛ
keel	ˈkɛl
pojem	ˈpɔjɛm
zotavený	ˈzɔtavɛniː
kamera	ˈkamɛra
zákazu	ˈzaːkazu
kpa	ˈkpa
smele	ˈsmɛlɛ
jozem	ˈjɔzɛm
voltový	ˈvɔltɔviː
boduje	ˈbɔdujɛ
potulná	ˈpɔtulnaː
slovak	ˈsɫɔvak
slovným	ˈsɫɔvniːm
kostru	ˈkɔstru
tudu	ˈtudu
zdasa	ˈzdasa
zaka	ˈzaka
karensky	ˈkarɛnski
horrím	ˈɦɔriːm
sladím	ˈsɫadiːm
bosích	ˈbɔsiːx
postely	ˈpɔstɛli
kupel	ˈkupɛl
doralee	ˈdɔralɛ
poznamka	ˈpɔznamka
držku	ˈdrʒku
župane	ˈʒupaɲɛ
banket	ˈbankɛt
spokojím	ˈspɔkɔjiːm
vedoucí	ˈvɛdɔutsiː
teby	ˈtɛbi
poznačí	ˈpɔznatʃiː
výdavku	ˈviːdavku
prosíš	ˈprɔsiːʃ
bojec	ˈbɔjɛt
zmeškaný	ˈzmɛʃkaniː
modlíte	ˈmɔdliːtɛ
plátna	ˈpɫaːtna
sava	ˈsava
upra	ˈupra
vzdaní	ˈvzdaɲiː
johne	ˈjɔɦnɛ
haku	ˈɦaku
zmeskal	ˈzmɛskal
sumu	ˈsumu
hoj	ˈɦɔj
neruší	ˈɲɛruʃiː
zaryje	ˈzarijɛ
kapor	ˈkapɔr
zotrem	ˈzɔtrɛm
svedomý	ˈsvɛdɔmiː
preskoč	ˈprɛskɔt
mokrí	ˈmɔkriː
pase	ˈpasɛ
zvučku	ˈzvutʃku
ceda	ˈtsɛda
čoje	ˈtʃɔjɛ
stupňe	ˈstupɲɛ
smudná	ˈsmudnaː
modre	ˈmɔdrɛ
zlej	ˈzɫɛj
vrzne	ˈvrzɲɛ
zrobí	ˈzrɔbiː
korze	ˈkɔrzɛ
svena	ˈsvɛna
komare	ˈkɔmarɛ
slabo	ˈsɫabɔ
kvetín	ˈkvɛtiːn
výstredný	ˈviːstrɛdniː
kahn	ˈkaɦn
skumal	ˈskumal
vam	ˈvam
zverov	ˈzvɛrɔv
zosadíš	ˈzɔsadiːʃ
pome	ˈpɔmɛ
stlp	ˈstɫp
vstu	ˈvstu
doprac	ˈdɔprat
padíka	ˈpadiːka
skočko	ˈskɔtʃkɔ
zadku	ˈzadku
venom	ˈvɛnɔm
basta	ˈbasta
verní	ˈvɛrniː
upadne	ˈupadɲɛ
budo	ˈbudɔ
zhod	ˈzhɔd
masový	ˈmasɔviː
strajk	ˈstrajk
jes	ˈjɛs
dodome	ˈdɔmɛ
krona	ˈkrɔna
sobe	ˈsɔbɛ
kráca	ˈkraːtsa
strunku	ˈstrunku
padnem	ˈpadɲɛm
stanu	ˈstanu
vyje	ˈvijɛ
bodným	ˈbɔdniːm
páka	ˈpaːka
kom	ˈkɔm
dolo	ˈdɔɫɔ
zrovnala	ˈzrɔvnalɑ
štveš	ˈʃtvɛʃ
zveda	ˈzvɛda
meška	ˈmɛʃka
stranov	ˈstranɔv
zabudnú	ˈzabudnuː
kučery	ˈkutʃɛri
stredných	ˈstrɛdniːx
stolo	ˈstɔɫɔ
plamenoch	ˈpɫamɛnɔx
trupov	ˈtrupɔv
dos	ˈdɔs
zachova	ˈzaxɔva
vychladne	ˈvixladɲɛ
dane	ˈdaɲɛ
zabudnes	ˈzabudɲɛs
vyborne	ˈvibɔrnɛ
bajnom	ˈbajnɔm
sadru	ˈsadru
cf	ˈts
dusený	ˈdusɛniː
topíme	ˈtɔpiːmɛ
zvas	ˈzvas
jat	ˈjat
konte	ˈkɔntɛ
poslu	ˈpɔsɫu
sere	ˈsɛrɛ
panský	ˈpanskiː
zabr	ˈzabr
tojho	ˈtɔjhɔ
stavku	ˈstavku
vozu	ˈvɔzu
karty	ˈkarti
sluho	ˈsɫuɦɔ
tuha	ˈtuɦa
vreca	ˈvrɛtsa
stvor	ˈstvɔr
spomalí	ˈspɔmaliː
sedzo	ˈsɛdzɔ
kopula	ˈkɔpula
caju	ˈtsaju
joj	ˈjɔj
podrobeným	ˈpɔdrɔbɛniːm
zrade	ˈzraɟɛ
sadr	ˈsadr
strelným	ˈstrɛlniːm
dospelu	ˈdɔspɛlu
bajk	ˈbajk
pesach	ˈpɛsax
bazom	ˈbazɔm
caru	ˈtsaru
bosnu	ˈbɔsnu
volbu	ˈvɔlbu
slamka	ˈsɫamka
strel	ˈstrɛl
dneš	ˈdɲɛʃ
pokusný	ˈpɔkusniː
janos	ˈjanɔs
stranok	ˈstranɔk
koselu	ˈkɔsɛlu
kamerka	ˈkamɛrka
zapadnem	ˈzapadɲɛm
predostrel	ˈprɛdɔstrɛl
hokus	ˈɦɔkus
sporí	ˈspɔriː
venku	ˈvɛnku
stave	ˈstavɛ
pomaha	ˈpɔmaɦa
slnkom	ˈsɫnkɔm
znakov	ˈznakɔv
vodný	ˈvɔdniː
dotýkal	ˈdɔtiːkal
zrovnal	ˈzrɔvnal
vysl	ˈvisl
vlada	ˈvɫada
postroj	ˈpɔstrɔj
ojo	ˈɔjɔ
vybuchla	ˈvibuxla
vaňou	ˈvaɲɔu
zvarme	ˈzvarmɛ
zobak	ˈzɔbak
zadusí	ˈzadusiː
mousa	ˈmɔusa
dovaríš	ˈdɔvariːʃ
kamel	ˈkamɛl
stavka	ˈstavka
treje	ˈtrɛjɛ
výskumní	ˈviːskumniː
zaduje	ˈzadujɛ
sefe	ˈsɛfɛ
morava	ˈmɔrava
kamoška	ˈkamɔʃka
zvane	ˈzvaɲɛ
bavíš	ˈbaviːʃ
zeje	ˈzɛjɛ
spoj	ˈspɔj
poštvem	ˈpɔʃtvɛm
kohla	ˈkɔɦɫa
chorom	ˈxɔrɔm
zdrojov	ˈzdrɔjɔv
kuma	ˈkuma
sady	ˈsadi
nadých	ˈnadiːx
depku	ˈdɛpku
zohal	ˈzɔɦal
spotí	ˈspɔtiː
dobtok	ˈdɔbtɔk
stanom	ˈstanɔm
skom	ˈskɔm
spáva	ˈspaːva
tromy	ˈtrɔmi
duje	ˈdujɛ
trepu	ˈtrɛpu
coma	ˈtsɔma
započína	ˈzapɔtʃiːna
solu	ˈsɔɫu
výrobu	ˈviːrɔbu
počom	ˈpɔtʃɔm
tuda	ˈtuda
streľal	ˈstrɛʎal
habu	ˈɦabu
zabe	ˈzabɛ
bazu	ˈbazu
dove	ˈdɔvɛ
zahre	ˈzaɦrɛ
vole	ˈvɔlɛ
droves	ˈdrɔvɛs
bodneš	ˈbɔdɲɛʃ
kromer	ˈkrɔmɛr
seš	ˈsɛʃ
bavy	ˈbavi
pojebac	ˈpɔjɛbat
dojest	ˈdɔjɛst
kočkou	ˈkɔtʃkɔu
zostupná	ˈzɔstupnaː
spovedaš	ˈspɔvɛdaʃ
bodnem	ˈbɔdɲɛm
spreje	ˈsprɛjɛ
temp	ˈtɛmp
tama	ˈtama
možnom	ˈmɔʒnɔm
svojích	ˈsvɔjiːx
suva	ˈsuva
stoh	ˈstɔɦ
zac	ˈzat
šeba	ˈʃɛba
pastna	ˈpastna
pesa	ˈpɛsa
jap	ˈjap
vecných	ˈvɛtsniːx
vysal	ˈvisal
vreco	ˈvrɛtsɔ
smes	ˈsmɛs
vystroj	ˈvistrɔj
bodovací	ˈbɔdɔvatsiː
zaletí	ˈzalɛtiː
škodí	ˈʃkɔdiː
tužba	ˈtuʒba
streľ	ˈstrɛʎ
copy	ˈtsɔpi
výsadok	ˈviːsadɔk
vypadku	ˈvipadku
jaho	ˈjaɦɔ
kvapel	ˈkvapɛl
soju	ˈsɔju
surely	ˈsurɛli
spoznás	ˈspɔznaːs
stredna	ˈstrɛdna
vybera	ˈvibɛra
sacky	ˈsatski
zvolených	ˈzvɔlɛniːx
sake	ˈsakɛ
švíku	ˈʃviːku
čož	ˈtʃɔʒ
zajra	ˈzajra
čur	ˈtʃur
spodu	ˈspɔdu
kraven	ˈkravɛn
krs	ˈkrs
banou	ˈbanɔu
dont	ˈdɔnt
varuj	ˈvaruj
masovu	ˈmasɔvu
venkat	ˈvɛnkat
vrazený	ˈvrazɛniː
drep	ˈdrɛp
zvaze	ˈzvazɛ
kolese	ˈkɔlɛsɛ
zrnkom	ˈzrnkɔm
cím	ˈtsiːm
strajky	ˈstrajki
strobel	ˈstrɔbɛl
vets	ˈvɛts
juuso	ˈjusɔ
zapotím	ˈzapɔtiːm
tompko	ˈtɔmpkɔ
that	ˈtɦat
zrnko	ˈzrnkɔ
kozu	ˈkɔzu
setre	ˈsɛtrɛ
kučera	ˈkutʃɛra
každo	ˈkaʒdɔ
sada	ˈsada
serme	ˈsɛrmɛ
baska	ˈbaska
vlase	ˈvɫasɛ
varuješ	ˈvarujɛʃ
pobežím	ˈpɔbɛʒiːm
ponás	ˈpɔnaːs
vyplače	ˈviplatʃɛ
zamorených	ˈzamɔrɛniːx
vrane	ˈvraɲɛ
poľa	ˈpɔʎa
todt	ˈtɔdt
zlata	ˈzɫata
zomba	ˈzɔmba
čík	ˈtʃiːk
zpo	ˈzpɔ
tíme	ˈtiːmɛ
treske	ˈtrɛskɛ
padneš	ˈpadɲɛʃ
toh	ˈtɔɦ
jasnom	ˈjasnɔm
polack	ˈpɔɫats
stvat	ˈstvat
džemuješ	ˈdʒɛmujɛʃ
badám	ˈbadaːm
koľo	ˈkɔʎɔ
darcek	ˈdartsɛk
vlasov	ˈvɫasɔv
vysledky	ˈvislɛdki
kupíme	ˈkupiːmɛ
modreho	ˈmɔdrɛhɔ
kopete	ˈkɔpɛtɛ
vete	ˈvɛtɛ
suzon	ˈsuzɔn
bojarom	ˈbɔjarɔm
zauceny	ˈzautsɛni
buna	ˈbuna
besným	ˈbɛsniːm
spadneš	ˈspadɲɛʃ
výrub	ˈviːrub
sondu	ˈsɔndu
nepod	ˈɲɛpɔd
trpý	ˈtrpiː
vety	ˈvɛti
nohý	ˈnɔɦiː
zdutí	ˈzdutiː
stavom	ˈstavɔm
monre	ˈmɔnrɛ
frajer	ˈfrajɛr
vodne	ˈvɔdɲɛ
zdvojený	ˈzdvɔjɛniː
ču	ˈtʃu
kamerový	ˈkamɛrɔviː
vypla	ˈvipla
korena	ˈkɔrɛna
toro	ˈtɔrɔ
saha	ˈsaɦa
zapískam	ˈzapiːskam
vetru	ˈvɛtru
spomenka	ˈspɔmɛnka
carrom	ˈtsarɔm
colon	ˈtsɔɫɔn
zlomu	ˈzɫɔmu
spas	ˈspas
dozrel	ˈdɔzrɛl
pombo	ˈpɔmbɔ
smu	ˈsmu
skool	ˈskɔɫ
saruf	ˈsaruf
buns	ˈbuns
damas	ˈdamas
pokosí	ˈpɔkɔsiː
voje	ˈvɔjɛ
stoja	ˈstɔja
zatku	ˈzatku
vedru	ˈvɛdru
bos	ˈbɔs
dvojmo	ˈdvɔjmɔ
horko	ˈɦɔrkɔ
zaklína	ˈzakliːna
suda	ˈsuda
depa	ˈdɛpa
stopov	ˈstɔpɔv
coro	ˈtsɔrɔ
samurel	ˈsamurɛl
pohnal	ˈpɔɦnal
vrte	ˈvrtɛ
tuma	ˈtuma
vyboríme	ˈvibɔriːmɛ
skladujem	ˈskladujɛm
sporum	ˈspɔrum
carovna	ˈtsarɔvna
tvojo	ˈtvɔjɔ
zdam	ˈzdam
komarov	ˈkɔmarɔv
jodla	ˈjɔdɫa
zrelom	ˈzrɛlɔm
seu	ˈsɛu
tsa	ˈtsa
toby	ˈtɔbi
strávený	ˈstraːvɛniː
svoja	ˈsvɔja
sobích	ˈsɔbiːx
stranky	ˈstranki
hom	ˈɦɔm
spoken	ˈspɔkɛn
dace	ˈdatsɛ
votný	ˈvɔtniː
zaskal	ˈzaskal
vzruseny	ˈvzrusɛni
zabera	ˈzabɛra
zadne	ˈzadɲɛ
our	ˈɔur
drobným	ˈdrɔbniːm
vyšle	ˈviʃlɛ
kapele	ˈkapɛlɛ
vtaň	ˈvtaɲ
pakel	ˈpakɛl
pozves	ˈpɔzvɛs
mecov	ˈmɛtsɔv
zmojho	ˈzmɔjhɔ
kožnou	ˈkɔʒnɔu
valen	ˈvalɛn
vražd	ˈvraʒd
soľných	ˈsɔʎniːx
žeravý	ˈʒɛraviː
svou	ˈsvɔu
vale	ˈvalɛ
výstave	ˈviːstavɛ
ses	ˈsɛs
pozríme	ˈpɔzriːmɛ
cholo	ˈxɔɫɔ
bosí	ˈbɔsiː
doro	ˈdɔrɔ
vodku	ˈvɔdku
kadet	ˈkadɛt
vyborna	ˈvibɔrna
zhu	ˈzhu
švík	ˈʃviːk
katove	ˈkatɔvɛ
bajku	ˈbajku
prednost	ˈprɛdnɔst
stromových	ˈstrɔmɔviːx
svetovu	ˈsvɛtɔvu
zapískaš	ˈzapiːskaʃ
paĺbe	ˈpabɛ
bakou	ˈbakɔu
volím	ˈvɔliːm
výšku	ˈviːʃku
poklesu	ˈpɔklɛsu
zastavka	ˈzastavka
stojaka	ˈstɔjaka
konava	ˈkɔnava
kolíne	ˈkɔliːnɛ
core	ˈtsɔrɛ
odno	ˈɔdnɔ
vyhladuj	ˈvihladuj
poznaní	ˈpɔznaɲiː
vrstve	ˈvrstvɛ
zmastí	ˈzmastiː
dvoj	ˈdvɔj
dovolím	ˈdɔvɔliːm
dospel	ˈdɔspɛl
čs	ˈtʃ
bedne	ˈbɛdɲɛ
dowu	ˈdɔu
zmuvu	ˈzmuvu
pokusom	ˈpɔkusɔm
čenk	ˈtʃɛnk
sporných	ˈspɔrniːx
čele	ˈtʃɛlɛ
zvar	ˈzvar
kranz	ˈkranz
zasteľ	ˈzastɛʎ
tomme	ˈtɔmɛ
zrna	ˈzrna
vasej	ˈvasɛj
spona	ˈspɔna
tes	ˈtɛs
krev	ˈkrɛv
cobre	ˈtsɔbrɛ
spoje	ˈspɔjɛ
baču	ˈbatʃu
porečo	ˈpɔrɛtʃɔ
medu	ˈmɛdu
morko	ˈmɔrkɔ
zauč	ˈzaut
zastrelo	ˈzastrɛlɔ
kamen	ˈkamɛn
zahra	ˈzaɦra
vrtul	ˈvrtul
beste	ˈbɛstɛ
vlakoch	ˈvɫakɔx
zusa	ˈzusa
pose	ˈpɔsɛ
zastrelený	ˈzastrɛlɛniː
sloh	ˈsɫɔɦ
cecku	ˈtsɛtsku
ned	ˈɲɛd
celný	ˈtsɛlniː
ľadový	ˈʎadɔviː
výzera	ˈviːzɛra
síly	ˈsiːli
pokusa	ˈpɔkusa
zvonov	ˈzvɔnɔv
zmeškal	ˈzmɛʃkal
stavu	ˈstavu
kere	ˈkɛrɛ
pažítka	ˈpaʒiːtka
dobroš	ˈdɔbrɔʃ
kuda	ˈkuda
stredu	ˈstrɛdu
vanka	ˈvanka
dube	ˈdubɛ
vymoc	ˈvimɔt
zvaľ	ˈzvaʎ
zahr	ˈzaɦr
vazou	ˈvazɔu
medovým	ˈmɛdɔviːm
kaare	ˈkarɛ
kamos	ˈkamɔs
bazových	ˈbazɔviːx
vlastným	ˈvɫastniːm
than	ˈtɦan
mocou	ˈmɔtsɔu
skaru	ˈskaru
vašľm	ˈvaʃʎm
sovych	ˈsɔvix
chopný	ˈxɔpniː
vypadne	ˈvipadɲɛ
stou	ˈstɔu
besných	ˈbɛsniːx
vaných	ˈvaniːx
bends	ˈbɛnds
dnešnom	ˈdɲɛʃnɔm
zvedkov	ˈzvɛdkɔv
suru	ˈsuru
kralovska	ˈkralɔvska
mojave	ˈmɔjavɛ
vera	ˈvɛra
javou	ˈjavɔu
kupovat	ˈkupɔvat
vykradol	ˈvikradɔl
kapote	ˈkapɔtɛ
vlajku	ˈvɫajku
zastavením	ˈzastavɛniːm
sušeným	ˈsuʃɛniːm
výše	ˈviːʃɛ
stopý	ˈstɔpiː
jonah	ˈjɔnaɦ
saron	ˈsarɔn
strašíme	ˈstraʃiːmɛ
bezvadne	ˈbɛzvadɲɛ
honah	ˈɦɔnaɦ
sasa	ˈsasa
zasta	ˈzasta
ondo	ˈɔndɔ
bedľa	ˈbɛdʎa
dopíše	ˈdɔpiːʃɛ
soke	ˈsɔkɛ
snos	ˈsnɔs
vredu	ˈvrɛdu
dolnu	ˈdɔɫnu
mond	ˈmɔnd
spravýš	ˈspraviːʃ
vonu	ˈvɔnu
zaroveň	ˈzarɔvɛɲ
choko	ˈxɔkɔ
vykol	ˈvikɔl
koze	ˈkɔzɛ
zľutuješ	ˈzʎujɛʃ
voľbu	ˈvɔʎbu
podpíšem	ˈpɔdpiːʃɛm
svomu	ˈsvɔmu
kola	ˈkɔɫa
bojara	ˈbɔjara
zaje	ˈzajɛ
spore	ˈspɔrɛ
kuje	ˈkujɛ
dvo	ˈdvɔ
volenou	ˈvɔlɛnɔu
draca	ˈdratsa
has	ˈɦas
nele	ˈɲɛlɛ
zakotvení	ˈzakɔtvɛniː
baso	ˈbasɔ
zuhe	ˈzuɦɛ
poľujem	ˈpɔʎujɛm
besa	ˈbɛsa
kunalov	ˈkunalɔv
zameraj	ˈzamɛraj
zaberu	ˈzabɛru
kocha	ˈkɔxa
kandor	ˈkandɔr
splavím	ˈspɫaviːm
hando	ˈɦandɔ
tajnou	ˈtajnɔu
zastavu	ˈzastavu
hoa	ˈɦɔa
svenov	ˈsvɛnɔv
kwaad	ˈkad
kokosu	ˈkɔsu
base	ˈbasɛ
ouou	ˈɔu
bada	ˈbada
zapru	ˈzapru
nerove	ˈɲɛrɔvɛ
soka	ˈsɔka
vazeny	ˈvazɛni
neeru	ˈɲɛru
salat	ˈsalat
volením	ˈvɔlɛniːm
hems	ˈɦɛms
basoch	ˈbasɔx
vetka	ˈvɛtka
suche	ˈsuxɛ
spovedí	ˈspɔvɛdiː
zeby	ˈzɛbi
doško	ˈdɔʃkɔ
saul	ˈsaul
posel	ˈpɔsɛl
vyhraj	ˈvihraj
verona	ˈvɛrɔna
sera	ˈsɛra
chomsky	ˈxɔmski
dort	ˈdɔrt
buha	ˈbuɦa
zberom	ˈzbɛrɔm
kaper	ˈkapɛr
sáva	ˈsaːva
cupu	ˈtsupu
zákrute	ˈzaːkrutɛ
vozím	ˈvɔziːm
kvok	ˈkvɔk
čarva	ˈtʃarva
zastava	ˈzastava
sedavé	ˈsɛdavɛː
kasy	ˈkasi
tse	ˈtsɛ
kuo	ˈkuɔ
stves	ˈstvɛs
spekulant	ˈspɛkulant
kujem	ˈkujɛm
mok	ˈmɔk
šepkaj	ˈʃɛpkaj
dovolenou	ˈdɔvɔlɛnɔu
zasada	ˈzasada
sektu	ˈsɛktu
kurv	ˈkurv
sladový	ˈsɫadɔviː
hrp	ˈɦrp
nadaný	ˈnadaniː
šestku	ˈʃɛstku
výbore	ˈviːbɔrɛ
smelý	ˈsmɛliː
koa	ˈkɔa
slzný	ˈsɫzniː
zvalí	ˈzvaliː
tornado	ˈtɔrnadɔ
štastní	ˈʃtastniː
prelomený	ˈprɛlɔmɛniː
kach	ˈkax
jeh	ˈjɛɦ
das	ˈdas
doda	ˈdɔda
plazím	ˈpɫaziːm
pozemkovy	ˈpɔzɛmkɔvi
kva	ˈkva
vekov	ˈvɛkɔv
čaký	ˈtʃakiː
dravo	ˈdravɔ
sanoku	ˈsanɔku
hradom	ˈɦradɔm
kuva	ˈkuva
stravenym	ˈstravɛnim
suz	ˈsuz
strašno	ˈstraʃnɔ
sandra	ˈsandra
zvoň	ˈzvɔɲ
možnu	ˈmɔʒnu
zdrave	ˈzdravɛ
dvorku	ˈdvɔrku
spaja	ˈspaja
sezonu	ˈsɛzɔnu
stanoval	ˈstanɔval
vma	ˈvma
kaze	ˈkazɛ
placka	ˈpɫatska
bazuk	ˈbazuk
monde	ˈmɔndɛ
setom	ˈsɛtɔm
posudkom	ˈpɔsudkɔm
sonak	ˈsɔnak
kača	ˈkatʃa
podvolí	ˈpɔdvɔliː
dvam	ˈdvam
doprave	ˈdɔpravɛ
zdravému	ˈzdravɛːmu
vlo	ˈvɫɔ
monou	ˈmɔnɔu
trona	ˈtrɔna
pastelky	ˈpastɛlki
trojanom	ˈtrɔjanɔm
carom	ˈtsarɔm
vzopne	ˈvzɔpɲɛ
zahalí	ˈzaɦaliː
zobud	ˈzɔbud
srde	ˈsrɟɛ
stredná	ˈstrɛdnaː
celo	ˈtsɛlɔ
donat	ˈdɔnat
bojac	ˈbɔjat
vanko	ˈvankɔ
sabe	ˈsabɛ
sola	ˈsɔɫa
poserem	ˈpɔsɛrɛm
who	ˈɦɔ
hambu	ˈɦambu
zdravíš	ˈzdraviːʃ
vybel	ˈvibɛɫ
botasku	ˈbɔtasku
botasky	ˈbɔtaski
kopýt	ˈkɔpiːt
duke	ˈdukɛ
badena	ˈbadɛna
šedom	ˈʃɛdɔm
vou	ˈvɔu
polejte	ˈpɔlɛjtɛ
veck	ˈvɛts
zlatku	ˈzɫatku
kule	ˈkulɛ
výšký	ˈviːʃkiː
haste	ˈɦastɛ
krem	ˈkrɛm
sra	ˈsra
zak	ˈzak
cobru	ˈtsɔbru
sprosta	ˈsprɔsta
dokon	ˈdɔkɔn
hwana	ˈɦana
zmyslom	ˈzmislɔm
poznaš	ˈpɔznaʃ
mešít	ˈmɛʃiːt
štastný	ˈʃtastniː
sauret	ˈsaurɛt
vybraných	ˈvibraniːx
vacku	ˈvatsku
zakrute	ˈzakrutɛ
zdobený	ˈzdɔbɛniː
plads	ˈpɫads
kľuče	ˈkʎutʃɛ
pozkaj	ˈpɔzkaj
výsledký	ˈviːslɛdkiː
volare	ˈvɔlɑrɛ
vetach	ˈvɛtax
dlažbu	ˈdɫaʒbu
zube	ˈzubɛ
vravíme	ˈvraviːmɛ
zpat	ˈzpat
čaru	ˈtʃaru
vzdaj	ˈvzdaj
chock	ˈxɔts
spoznám	ˈspɔznaːm
vres	ˈvrɛs
dodda	ˈdɔda
vakov	ˈvakɔv
veron	ˈvɛrɔn
basou	ˈbasɔu
vorenus	ˈvɔrɛnus
šere	ˈʃɛrɛ
podpíš	ˈpɔdpiːʃ
spek	ˈspɛk
nespadne	ˈɲɛspadɲɛ
count	ˈtsɔunt
zdrav	ˈzdrav
moods	ˈmɔds
vletím	ˈvɫɛtiːm
spodný	ˈspɔdniː
sedol	ˈsɛdɔɫ
sebas	ˈsɛbas
steste	ˈstɛstɛ
varoval	ˈvarɔval
zvoľ	ˈzvɔʎ
strelný	ˈstrɛlniː
splašený	ˈspɫaʃɛniː
vatru	ˈvatru
sonu	ˈsɔnu
slávna	ˈsɫaːvna
drvíš	ˈdrviːʃ
zalejte	ˈzalɛjtɛ
vežka	ˈvɛʒka
každu	ˈkaʒdu
sára	ˈsaːra
vprvom	ˈvprvɔm
zmatku	ˈzmatku
zohnalo	ˈzɔɦnalɔ
královna	ˈkraːɫɔvna
bare	ˈbarɛ
dojazd	ˈdɔjazd
strojný	ˈstrɔjniː
jony	ˈjɔni
plaveckom	ˈpɫavɛtskɔm
spoľ	ˈspɔʎ
hrbíš	ˈɦrbiːʃ
postvat	ˈpɔstvat
vankus	ˈvankus
kormu	ˈkɔrmu
dust	ˈdust
šabrok	ˈʃabrɔk
šomra	ˈʃɔmra
pametate	ˈpamɛtatɛ
skety	ˈskɛti
hoja	ˈɦɔja
tvoríme	ˈtvɔriːmɛ
sonar	ˈsɔnar
sameer	ˈsamɛr
šas	ˈʃas
poserov	ˈpɔsɛrɔv
dobremu	ˈdɔbrɛmu
kolecko	ˈkɔlɛtskɔ
velmu	ˈvɛɫmu
hrab	ˈɦrab
bones	ˈbɔnɛs
krovísk	ˈkrɔviːsk
padneme	ˈpadɲɛmɛ
debut	ˈdɛbut
jorem	ˈjɔrɛm
novaro	ˈnɔvarɔ
stopol	ˈstɔpɔɫ
zvaríme	ˈzvariːmɛ
moku	ˈmɔku
krasa	ˈkrasa
mozu	ˈmɔzu
straznych	ˈstraznix
voď	ˈvɔɟ
padnes	ˈpadɲɛs
zapasu	ˈzapasu
vzne	ˈvzɲɛ
zješ	ˈzjɛʃ
prajes	ˈprajɛs
torn	ˈtɔrn
dýka	ˈdiːka
výhoda	ˈviːhɔda
dostupný	ˈdɔstupniː
seky	ˈsɛki
jews	ˈjɛs
kvetu	ˈkvɛtu
kome	ˈkɔmɛ
vom	ˈvɔm
velmo	ˈvɛɫmɔ
zloto	ˈzɫɔtɔ
zohral	ˈzɔɦral
zástupe	ˈzaːstupɛ
kars	ˈkars
druhe	ˈdruhɛ
havaj	ˈɦavaj
poľuje	ˈpɔʎujɛ
smreku	ˈsmrɛku
zvanou	ˈzvanɔu
dumu	ˈdumu
stanov	ˈstanɔv
sara	ˈsara
bolee	ˈbɔlɛ
mos	ˈmɔs
troje	ˈtrɔjɛ
vrtnou	ˈvrtnɔu
vlastnu	ˈvɫastnu
vetkých	ˈvɛtkiːx
stvorením	ˈstvɔrɛniːm
spredu	ˈsprɛdu
spo	ˈspɔ
plazíme	ˈpɫaziːmɛ
tena	ˈtɛna
slamu	ˈsɫamu
mošno	ˈmɔʃnɔ
vymena	ˈvimɛna
smelí	ˈsmɛliː
posed	ˈpɔsɛd
dume	ˈdumɛ
mojenko	ˈmɔjɛnkɔ
spustu	ˈspustu
vladnej	ˈvɫadɲɛj
debs	ˈdɛbs
kanu	ˈkanu
haka	ˈɦaka
stvo	ˈstvɔ
černy	ˈtʃɛrni
vedat	ˈvɛdat
vládna	ˈvɫaːdna
bankou	ˈbankɔu
sojam	ˈsɔjam
posun	ˈpɔsun
vraku	ˈvraku
zotavuje	ˈzɔtavujɛ
kapore	ˈkapɔrɛ
horna	ˈɦɔrna
kapre	ˈkaprɛ
pojo	ˈpɔjɔ
vysajem	ˈvisajɛm
vasou	ˈvasɔu
strunk	ˈstrunk
černý	ˈtʃɛrniː
ńou	ˈɔu
bonusové	ˈbɔnusɔvɛː
speks	ˈspɛks
hrda	ˈɦrda
svým	ˈsviːm
dostrele	ˈdɔstrɛlɛ
pasením	ˈpasɛniːm
stup	ˈstup
dravej	ˈdravɛj
vetra	ˈvɛtra
soj	ˈsɔj
moro	ˈmɔrɔ
daruj	ˈdaruj
vnej	ˈvɲɛj
tajomní	ˈtajɔmniː
dvaje	ˈdvajɛ
valí	ˈvaliː
zdrava	ˈzdrava
kopaj	ˈkɔpaj
zotavíš	ˈzɔtaviːʃ
bodlo	ˈbɔdɫɔ
dbaj	ˈdbaj
baf	ˈbaf
vare	ˈvarɛ
soba	ˈsɔba
zmaž	ˈzmaʒ
zapíš	ˈzapiːʃ
stlač	ˈstɫat
dvor	ˈdvɔr
zatajím	ˈzatajiːm
výkoný	ˈviːkɔniː
dobrak	ˈdɔbrak
soku	ˈsɔku
vos	ˈvɔs
spa	ˈspa
výpadku	ˈviːpadku
belošku	ˈbɛɫɔʃku
výpove	ˈviːpɔvɛ
modrých	ˈmɔdriːx
ˇpor	ˈpɔr
upla	ˈupɫa
tvorom	ˈtvɔrɔm
kasou	ˈkasɔu
kano	ˈkanɔ
zapretý	ˈzaprɛtiː
svalov	ˈsvalɔv
vrme	ˈvrmɛ
strednom	ˈstrɛdnɔm
pozvem	ˈpɔzvɛm
sanku	ˈsanku
dromas	ˈdrɔmas
jasnu	ˈjasnu
večným	ˈvɛtʃniːm
zraň	ˈzraɲ
sporoch	ˈspɔrɔx
bus	ˈbus
sunar	ˈsunar
dp	ˈdp
kupem	ˈkupɛm
stands	ˈstands
ksl	ˈksɫ
vstaň	ˈvstaɲ
saku	ˈsaku
výstavku	ˈviːstavku
sadení	ˈsaɟɛniː
saref	ˈsarɛf
zvrstvená	ˈzvrstvɛnaː
cely	ˈtsɛli
kente	ˈkɛntɛ
sreb	ˈsrɛb
kožko	ˈkɔʒkɔ
slovensk	ˈsɫɔʋɛnsk
bažíš	ˈbaʒiːʃ
zlte	ˈzɫtɛ
zapoja	ˈzapɔja
horar	ˈɦɔrar
zdaju	ˈzdaju
pľuješ	ˈpʎujɛʃ
kralovsku	ˈkralɔvsku
dunach	ˈdunax
kasa	ˈkasa
colm	ˈtsɔɫm
stroho	ˈstrɔɦɔ
stoupa	ˈstɔupa
jaspa	ˈjaspa
skoná	ˈskɔnaː
seely	ˈsɛli
stun	ˈstun
sumou	ˈsumɔu
somára	ˈsɔmaːra
suším	ˈsuʃiːm
skar	ˈskar
povedomý	ˈpɔvɛdɔmiː
spomeň	ˈspɔmɛɲ
heem	ˈɦɛm
sprejom	ˈsprɛjɔm
svorku	ˈsvɔrku
preso	ˈprɛsɔ
zamotaj	ˈzamɔtaj
vaku	ˈvaku
domový	ˈdɔmɔviː
krpatý	ˈkrpatiː
kroda	ˈkrɔda
probes	ˈprɔbɛs
spokojný	ˈspɔkɔjniː
dokonal	ˈdɔkɔnal
duseným	ˈdusɛniːm
theny	ˈtɦɛni
šopa	ˈʃɔpa
prosíím	ˈprɔsiːm
volených	ˈvɔlɛniːx
zohrala	ˈzɔɦralɑ
vlakova	ˈvɫakɔva
makových	ˈmakɔviːx
doplna	ˈdɔpɫna
kuram	ˈkuram
vojaku	ˈvɔjaku
zapíšem	ˈzapiːʃɛm
kopí	ˈkɔpiː
podlých	ˈpɔdliːx
zobr	ˈzɔbr
presnym	ˈprɛsnim
vena	ˈvɛna
koča	ˈkɔtʃa
kawako	ˈkakɔ
štvaný	ˈʃtvaniː
vlaj	ˈvɫaj
nedovo	ˈɲɛdɔvɔ
dozen	ˈdɔzɛn
zložku	ˈzɫɔʒku
jau	ˈjau
kato	ˈkatɔ
doskovej	ˈdɔskɔvɛj
speje	ˈspɛjɛ
vas	ˈvas
sokel	ˈsɔkɛl
zna	ˈzna
banta	ˈbanta
skate	ˈskatɛ
zhoduje	ˈzhɔdujɛ
slušných	ˈsɫuʃniːx
moran	ˈmɔran
splátka	ˈspɫaːtka
pozret	ˈpɔzrɛt
bozej	ˈbɔzɛj
stavaju	ˈstavaju
vatou	ˈvatɔu
zlost	ˈzɫɔst
doback	ˈdɔbats
zhor	ˈzhɔr
zmenou	ˈzmɛnɔu
šer	ˈʃɛr
bezpe	ˈbɛzpɛ
hasí	ˈɦasiː
vyhovel	ˈvihɔvɛɫ
vysluch	ˈvislux
slaný	ˈsɫaniː
tvojm	ˈtvɔjm
zvedov	ˈzvɛdɔv
zabudas	ˈzabudas
odnu	ˈɔdnu
číra	ˈtʃiːra
zrovnaný	ˈzrɔvnaniː
smerný	ˈsmɛrniː
zlovo	ˈzɫɔvɔ
vnorí	ˈvnɔriː
zaklad	ˈzaklad
skapu	ˈskapu
pastvam	ˈpastvam
spolou	ˈspɔɫɔu
posere	ˈpɔsɛrɛ
ducu	ˈdutsu
zoberu	ˈzɔbɛru
kolesu	ˈkɔlɛsu
vráta	ˈvraːta
vlkom	ˈvɫkɔm
vysloví	ˈvislɔviː
zlty	ˈzɫti
stonku	ˈstɔnku
zmaľuje	ˈzmaʎujɛ
pojal	ˈpɔjal
trvalým	ˈtrvaliːm
pustím	ˈpustiːm
bojom	ˈbɔjɔm
kammo	ˈkamɔ
možná	ˈmɔʒnaː
sureš	ˈsurɛʃ
zbrklí	ˈzbrkliː
honk	ˈɦɔnk
roseho	ˈrɔsɛhɔ
zmeň	ˈzmɛɲ
čaruj	ˈtʃaruj
znakom	ˈznakɔm
jas	ˈjas
kostí	ˈkɔstiː
sark	ˈsark
slaven	ˈsɫavɛn
budut	ˈbudut
zvedavé	ˈzvɛdavɛː
vazu	ˈvazu
veno	ˈvɛnɔ
tube	ˈtubɛ
zant	ˈzant
dvoma	ˈdvɔma
zhojí	ˈzhɔjiː
drvený	ˈdrvɛniː
zberač	ˈzbɛrat
vosk	ˈvɔsk
slavík	ˈsɫaviːk
baští	ˈbaʃtiː
haman	ˈɦaman
spravu	ˈspravu
skur	ˈskur
čurák	ˈtʃuraːk
kožná	ˈkɔʒnaː
vzlety	ˈvzɫɛti
bustu	ˈbustu
vodam	ˈvɔdam
vršku	ˈvrʃku
pabst	ˈpabst
slamený	ˈsɫamɛniː
strandu	ˈstrandu
počuje	ˈpɔtʃujɛ
saula	ˈsaula
thana	ˈtɦana
dresa	ˈdrɛsa
vrob	ˈvrɔb
orly	ˈɔrli
čyři	ˈtʃi
bodujem	ˈbɔdujɛm
svedomím	ˈsvɛdɔmiːm
morkom	ˈmɔrkɔm
kvetý	ˈkvɛtiː
člnu	ˈtʃɫnu
vsak	ˈvsak
zadusíš	ˈzadusiːʃ
budom	ˈbudɔm
kompa	ˈkɔmpa
tep	ˈtɛp
havaja	ˈɦavaja
člna	ˈtʃɫna
kosel	ˈkɔsɛl
držbu	ˈdrʒbu
stalč	ˈstalt
sevas	ˈsɛvas
páska	ˈpaːska
vletku	ˈvɫɛtku
vyšlem	ˈviʃlɛm
kedže	ˈkɛdʒɛ
duc	ˈdut
kuša	ˈkuʃa
veslom	ˈvɛsɫɔm
slovna	ˈsɫɔvna
joha	ˈjɔɦa
dlažku	ˈdɫaʒku
poznajem	ˈpɔznajɛm
vypľuje	ˈvipʎujɛ
hasta	ˈɦasta
zavesí	ˈzavɛsiː
zbavením	ˈzbavɛniːm
zona	ˈzɔna
podtým	ˈpɔdtiːm
spíma	ˈspiːma
čara	ˈtʃara
dojalo	ˈdɔjalɔ
cern	ˈtsɛrn
vanu	ˈvanu
pohladu	ˈpɔɦɫadu
staje	ˈstajɛ
zme	ˈzmɛ
volnu	ˈvɔlnu
kol	ˈkɔɫ
zobereš	ˈzɔbɛrɛʃ
znaku	ˈznaku
poznam	ˈpɔznam
sarma	ˈsarma
chramu	ˈxramu
spolok	ˈspɔɫɔk
sambora	ˈsambɔra
vletí	ˈvɫɛtiː
spet	ˈspɛt
bope	ˈbɔpɛ
sobre	ˈsɔbrɛ
bazenov	ˈbazɛnɔv
stromový	ˈstrɔmɔviː
poznačený	ˈpɔznatʃɛniː
zkrátka	ˈzkraːtka
nepekný	ˈɲɛpɛkniː
mocu	ˈmɔtsu
valou	ˈvalɔu
dojku	ˈdɔjku
moëtu	ˈmɔtu
kojený	ˈkɔjɛniː
sura	ˈsura
jebeš	ˈjɛbɛʃ
strombo	ˈstrɔmbɔ
boše	ˈbɔʃɛ
voskový	ˈvɔskɔviː
pasta	ˈpasta
sou	ˈsɔu
vonný	ˈvɔnniː
bakes	ˈbakɛs
posím	ˈpɔsiːm
zlavu	ˈzɫavu
smeruj	ˈsmɛruj
sajnu	ˈsajnu
zorka	ˈzɔrka
volaj	ˈvɔlɑj
kovac	ˈkɔvat
bavím	ˈbaviːm
stejkoch	ˈstɛjkɔx
zbeh	ˈzbɛɦ
dokov	ˈdɔkɔv
strubel	ˈstrubɛl
pojedla	ˈpɔjɛdɫa
zhrbeny	ˈzhrbɛni
šejka	ˈʃɛjka
skovaj	ˈskɔvaj
tampon	ˈtampɔn
spím	ˈspiːm
dotkne	ˈdɔtkɲɛ
sopa	ˈsɔpa
vrstvená	ˈvrstvɛnaː
sodu	ˈsɔdu
velma	ˈvɛɫma
horesa	ˈɦɔrɛsa
modlení	ˈmɔdlɛniː
tho	ˈtɦɔ
škrab	ˈʃkrab
kose	ˈkɔsɛ
sapna	ˈsapna
zrovna	ˈzrɔvna
svetým	ˈsvɛtiːm
naucí	ˈnautsiː
skonč	ˈskɔnt
sanka	ˈsanka
bejako	ˈbɛjakɔ
zmerom	ˈzmɛrɔm
troja	ˈtrɔja
tvojeho	ˈtvɔjɛhɔ
dneska	ˈdɲɛska
žrebu	ˈʒrɛbu
bodnej	ˈbɔdɲɛj
choco	ˈxɔtsɔ
krajec	ˈkrajɛt
stolu	ˈstɔɫu
duní	ˈduniː
ktoho	ˈktɔɦɔ
vada	ˈvada
vlno	ˈvɫnɔ
kozmu	ˈkɔzmu
čaruje	ˈtʃarujɛ
baletka	ˈbaɫɛtka
dojeme	ˈdɔjɛmɛ
hamu	ˈɦamu
veras	ˈvɛras
mou	ˈmɔu
porast	ˈpɔrast
sudruh	ˈsudruh
krep	ˈkrɛp
vezmu	ˈvɛzmu
kotex	ˈkɔtɛk
vyjedá	ˈvijɛdaː
joyom	ˈjɔm
zvonec	ˈzvɔnɛt
skovam	ˈskɔvam
vasen	ˈvasɛn
komnatu	ˈkɔmnatu
drza	ˈdrza
koralov	ˈkɔralɔv
znas	ˈznas
dobý	ˈdɔbiː
verných	ˈvɛrniːx
ced	ˈtsɛd
krvák	ˈkrvaːk
zotrela	ˈzɔtrɛlɑ
soje	ˈsɔjɛ
upeč	ˈupɛt
výra	ˈviːra
ponaras	ˈpɔnaras
hombre	ˈɦɔmbrɛ
voc	ˈvɔt
musíto	ˈmusiːtɔ
spršku	ˈsprʃku
postím	ˈpɔstiːm
vypad	ˈvipad
volam	ˈvɔlɑm
jaroda	ˈjarɔda
krízy	ˈkriːzi
scotovým	ˈstɔviːm
tlapa	ˈtɫapa
vudu	ˈvudu
čety	ˈtʃɛti
tope	ˈtɔpɛ
hanka	ˈɦanka
zbroj	ˈzbrɔj
vyhrame	ˈvihramɛ
zast	ˈzast
corona	ˈtsɔrɔna
kapes	ˈkapɛs
týžd	ˈtiːʒd
pojebes	ˈpɔjɛbɛs
hadn	ˈɦadn
struk	ˈstruk
posuva	ˈpɔsuva
kara	ˈkara
sap	ˈsap
jason	ˈjasɔn
chopru	ˈxɔpru
trop	ˈtrɔp
balím	ˈbaɫiːm
zakodovaný	ˈzakɔdɔvaniː
sove	ˈsɔvɛ
pochopí	ˈpɔxɔpiː
saf	ˈsaf
jom	ˈjɔm
doral	ˈdɔral
tajoch	ˈtajɔx
započujem	ˈzapɔtʃujɛm
vyplatu	ˈviplatu
hasar	ˈɦasar
zabudnem	ˈzabudɲɛm
koču	ˈkɔtʃu
duca	ˈdutsa
zvratok	ˈzvratɔk
karol	ˈkarɔl
kusa	ˈkusa
poškrabem	ˈpɔʃkrabɛm
jambe	ˈjambɛ
zasuň	ˈzasuɲ
skurven	ˈskurvɛn
zvejme	ˈzvɛjmɛ
dors	ˈdɔrs
beds	ˈbɛds
vrakov	ˈvrakɔv
vobec	ˈvɔbɛt
koral	ˈkɔral
zdobíš	ˈzdɔbiːʃ
povesíš	ˈpɔvɛsiːʃ
masoví	ˈmasɔviː
šokuj	ˈʃɔkuj
kova	ˈkɔva
zosuv	ˈzɔsuv
beza	ˈbɛza
kos	ˈkɔs
sabor	ˈsabɔr
spon	ˈspɔn
medrano	ˈmɛdranɔ
zajest	ˈzajɛst
krasoň	ˈkrasɔɲ
škvarí	ˈʃkvariː
dolku	ˈdɔɫku
zahrala	ˈzaɦrala
vojím	ˈvɔjiːm
zrobím	ˈzrɔbiːm
zmestí	ˈzmɛstiː
vežký	ˈvɛʒkiː
dovera	ˈdɔvɛra
wore	ˈɔrɛ
zostromu	ˈzɔstrɔmu
chola	ˈxɔɫa
výmol	ˈviːmɔl
hoke	ˈɦɔkɛ
dortu	ˈdɔrtu
zvonu	ˈzvɔnu
zahada	ˈzaɦada
puis	ˈpus
bolá	ˈbɔɫaː
štvem	ˈʃtvɛm
bata	ˈbata
zmrvený	ˈzmrvɛniː
presno	ˈprɛsnɔ
vojsk	ˈvɔjsk
kosí	ˈkɔsiː
výchove	ˈviːxɔvɛ
veľkus	ˈvɛʎkus
slavnom	ˈsɫavnɔm
došku	ˈdɔʃku
paulíne	ˈpauliːnɛ
boseho	ˈbɔsɛhɔ
vareným	ˈvarɛniːm
dopíšeme	ˈdɔpiːʃɛmɛ
vrze	ˈvrzɛ
moca	ˈmɔtsa
busta	ˈbusta
spovedník	ˈspɔvɛdɲiːk
ztratím	ˈztratiːm
saurus	ˈsaurus
karam	ˈkaram
betka	ˈbɛtka
cem	ˈtsɛm
doba	ˈdɔba
zľaka	ˈzʎaka
haslo	ˈɦasɫɔ
kantov	ˈkantɔv
trej	ˈtrɛj
tjap	ˈtjap
pokrája	ˈpɔkraːja
dvojtý	ˈdvɔjtiː
zaseje	ˈzasɛjɛ
kanta	ˈkanta
šerom	ˈʃɛrɔm
krav	ˈkrav
jíst	ˈjiːst
štvoro	ˈʃtvɔrɔ
nadýcha	ˈnadiːxa
kolu	ˈkɔɫu
výrus	ˈviːrus
seb	ˈsɛb
mojko	ˈmɔjkɔ
vozna	ˈvɔzna
toje	ˈtɔjɛ
stastní	ˈstastniː
basket	ˈbaskɛt
šable	ˈʃablɛ
smrek	ˈsmrɛk
sprat	ˈsprat
pojeme	ˈpɔjɛmɛ
bed	ˈbɛd
bazda	ˈbazda
skonal	ˈskɔnal
pozemkový	ˈpɔzɛmkɔviː
tombo	ˈtɔmbɔ
zeebad	ˈzɛbad
dola	ˈdɔɫa
zmotaný	ˈzmɔtaniː
voskuješ	ˈvɔskujɛʃ
zlat	ˈzɫat
sadí	ˈsadiː
zva	ˈzva
kes	ˈkɛs
vrat	ˈvrat
halo	ˈɦaɫɔ
zosadí	ˈzɔsadiː
vasím	ˈvasiːm
vyhrala	ˈvihrala
vyhraia	ˈvihra
zjec	ˈzjɛt
tvarov	ˈtvarɔv
safe	ˈsafɛ
kuše	ˈkuʃɛ
kroc	ˈkrɔt
zvojho	ˈzvɔjhɔ
sos	ˈsɔs
posebe	ˈpɔsɛbɛ
stona	ˈstɔna
vecnu	ˈvɛtsnu
bose	ˈbɔsɛ
zastave	ˈzastavɛ
zlostí	ˈzɫɔstiː
santa	ˈsanta
doš	ˈdɔʃ
navodu	ˈnavɔdu
doj	ˈdɔj
započula	ˈzapɔtʃulɑ
pobudnem	ˈpɔbudɲɛm
podle	ˈpɔdlɛ
surnom	ˈsurnɔm
hraješ	ˈɦrajɛʃ
zvraca	ˈzvratsa
veerou	ˈvɛrɔu
vaty	ˈvati
dames	ˈdamɛs
zasklí	ˈzaskliː
svedka	ˈsvɛdka
nemkou	ˈɲɛmkɔu
dorazme	ˈdɔrazmɛ
zrubu	ˈzrubu
mackou	ˈmatskɔu
daws	ˈdas
serna	ˈsɛrna
dorovnal	ˈdɔrɔvnal
spokojným	ˈspɔkɔjniːm
chok	ˈxɔk
kempy	ˈkɛmpi
zmerat	ˈzmɛrat
mouse	ˈmɔusɛ
domace	ˈdɔmatsɛ
strukov	ˈstrukɔv
slav	ˈsɫav
zaruku	ˈzaruku
vpredu	ˈvprɛdu
stud	ˈstud
zakotví	ˈzakɔtviː
čajou	ˈtʃajɔu
vasu	ˈvasu
tují	ˈtujiː
tucha	ˈtuxa
steelom	ˈstɛlɔm
stredovek	ˈstrɛdɔvɛk
carm	ˈtsarm
zadných	ˈzadniːx
zvratom	ˈzvratɔm
znat	ˈznat
tepna	ˈtɛpna
kupova	ˈkupɔva
ženšenový	ˈʒɛnɔviː
vśetkých	ˈvɛtkiːx
zdroja	ˈzdrɔja
podnebných	ˈpɔdɲɛbniːx
budapest	ˈbudapɛst
kopat	ˈkɔpat
svojemu	ˈsvɔjɛmu
chova	ˈxɔva
smeru	ˈsmɛru
šov	ˈʃɔv
jamo	ˈjamɔ
senom	ˈsɛnɔm
zjaví	ˈzjaviː
serrano	ˈsɛranɔ
sprava	ˈsprava
slušná	ˈsɫuʃnaː
volna	ˈvɔlna
vyhladovaný	ˈvihladɔvaniː
troske	ˈtrɔskɛ
šao	ˈʃaɔ
vaca	ˈvatsa
šľap	ˈʃʎap
verná	ˈvɛrnaː
vzdor	ˈvzdɔr
konec	ˈkɔnɛt
boomera	ˈbɔmɛra
vlnka	ˈvɫnka
zlostný	ˈzɫɔstniː
sena	ˈsɛna
pralesom	ˈpralɛsɔm
kurte	ˈkurtɛ
valom	ˈvalɔm
vírový	ˈviːrɔviː
pokusíme	ˈpɔkusiːmɛ
duce	ˈdutsɛ
snou	ˈsnɔu
čest	ˈtʃɛst
spent	ˈspɛnt
pozrel	ˈpɔzrɛl
zatavený	ˈzatavɛniː
pornoš	ˈpɔrnɔʃ
vrecka	ˈvrɛtska
psím	ˈpsiːm
čaja	ˈtʃaja
baal	ˈbaɫ
čístý	ˈtʃiːstiː
vylej	ˈvilɛj
drbov	ˈdrbɔv
sadaj	ˈsadaj
dora	ˈdɔra
strope	ˈstrɔpɛ
zvol	ˈzvɔl
veslam	ˈvɛsɫam
štrajku	ˈʃtrajku
spreja	ˈsprɛja
vyštal	ˈviʃtal
jožko	ˈjɔʒkɔ
zvaľte	ˈzvaʎtɛ
kora	ˈkɔra
soko	ˈsɔkɔ
šarkan	ˈʃarkan
bojarov	ˈbɔjarɔv
vadní	ˈvadɲiː
postalo	ˈpɔstɑlɔ
nehľade	ˈɲɛɦʎaɟɛ
poznatkov	ˈpɔznatkɔv
čaju	ˈtʃaju
zbroje	ˈzbrɔjɛ
veľm	ˈvɛʎm
strajku	ˈstrajku
pskov	ˈpskɔv
kravský	ˈkravskiː
sawada	ˈsada
vedrom	ˈvɛdrɔm
stranou	ˈstranɔu
pokute	ˈpɔkutɛ
presnom	ˈprɛsnɔm
kulový	ˈkulɔviː
zore	ˈzɔrɛ
výtvoj	ˈviːtvɔj
slant	ˈsɫant
kapotu	ˈkapɔtu
bend	ˈbɛnd
zrus	ˈzrus
chradne	ˈxradɲɛ
zastavení	ˈzastavɛniː
vzdas	ˈvzdas
kady	ˈkadi
kurvo	ˈkurvɔ
dus	ˈdus
basov	ˈbasɔv
spolus	ˈspɔɫus
kupu	ˈkupu
monu	ˈmɔnu
zastavý	ˈzastaviː
výbavu	ˈviːbavu
sport	ˈspɔrt
koznu	ˈkɔznu
stemp	ˈstɛmp
štrnást	ˈʃtrnaːst
vystreľoval	ˈvistrɛʎɔval
skos	ˈskɔs
zdoj	ˈzdɔj
podnet	ˈpɔdɲɛt
doha	ˈdɔɦa
zaj	ˈzaj
sty	ˈsti
baretka	ˈbarɛtka
dvera	ˈdvɛra
povestných	ˈpɔvɛstniːx
busom	ˈbusɔm
spodom	ˈspɔdɔm
sedona	ˈsɛdɔna
bazen	ˈbazɛn
orko	ˈɔrkɔ
zakladných	ˈzakladniːx
zostupové	ˈzɔstupɔvɛː
mod	ˈmɔd
kandra	ˈkandra
postupom	ˈpɔstupɔm
sanovu	ˈsanɔvu
ketel	ˈkɛtɛl
temou	ˈtɛmɔu
mankova	ˈmankɔva
zatra	ˈzatra
vedze	ˈvɛdzɛ
konam	ˈkɔnam
vadne	ˈvadɲɛ
postu	ˈpɔstu
zdal	ˈzdal
splne	ˈspɫɲɛ
vymenou	ˈvimɛnɔu
skorí	ˈskɔriː
pusík	ˈpusiːk
sľud	ˈsʎud
zny	ˈzni
slanou	ˈsɫanɔu
udní	ˈudɲiː
posudku	ˈpɔsudku
šokuje	ˈʃɔkujɛ
karasawa	ˈkarasa
šejkom	ˈʃɛjkɔm
stome	ˈstɔmɛ
tobre	ˈtɔbrɛ
vozíme	ˈvɔziːmɛ
dou	ˈdɔu
potoka	ˈpɔtɔka
stavíme	ˈstaviːmɛ
premohol	ˈprɛmɔɦɔɫ
santal	ˈsantal
bezat	ˈbɛzat
vanov	ˈvanɔv
zety	ˈzɛti
strávenu	ˈstraːvɛnu
stvojím	ˈstvɔjiːm
síry	ˈsiːri
mods	ˈmɔds
varom	ˈvarɔm
mone	ˈmɔnɛ
bodo	ˈbɔdɔ
zadýcha	ˈzadiːxa
horná	ˈɦɔrnaː
karel	ˈkarɛl
bankova	ˈbankɔva
bate	ˈbatɛ
zap	ˈzap
baskov	ˈbaskɔv
sandru	ˈsandru
boje	ˈbɔjɛ
suboru	ˈsubɔru
moser	ˈmɔsɛr
jose	ˈjɔsɛ
postel	ˈpɔstɛl
teste	ˈtɛstɛ
zrej	ˈzrɛj
tolo	ˈtɔɫɔ
potíte	ˈpɔtiːtɛ
podst	ˈpɔdst
drbeš	ˈdrbɛʃ
sep	ˈsɛp
wbu	ˈbu
zradíme	ˈzraɟiːmɛ
tuje	ˈtujɛ
skaredu	ˈskarɛdu
dobrem	ˈdɔbrɛm
postelí	ˈpɔstɛliː
sonare	ˈsɔnarɛ
vakuum	ˈvakum
zaboha	ˈzabɔɦa
bední	ˈbɛdɲiː
dejtu	ˈdɛjtu
vezou	ˈvɛzɔu
zrovnaj	ˈzrɔvnaj
západne	ˈzaːpadɲɛ
čare	ˈtʃarɛ
spravíme	ˈspraviːmɛ
vonke	ˈvɔnkɛ
japon	ˈjapɔn
harm	ˈɦarm
dolný	ˈdɔɫniː
žasla	ˈʒasɫa
predošlý	ˈprɛdɔʃliː
nete	ˈɲɛtɛ
badu	ˈbadu
haber	ˈɦabɛr
vysle	ˈvislɛ
celky	ˈtsɛlki
bale	ˈbaɫɛ
stas	ˈstas
baja	ˈbaja
kompe	ˈkɔmpɛ
dneška	ˈdɲɛʃka
dumb	ˈdumb
somrak	ˈsɔmrak
stravenky	ˈstravɛnki
čp	ˈtʃp
verm	ˈvɛrm
zlatí	ˈzɫatiː
čulou	ˈtʃulɔu
stojky	ˈstɔjki
bolanda	ˈbɔɫanda
każdy	ˈkadi
pľuje	ˈpʎujɛ
buduj	ˈbuduj
výraze	ˈviːrazɛ
kavu	ˈkavu
sprobuj	ˈsprɔbuj
vastný	ˈvastniː
best	ˈbɛst
žabka	ˈʒabka
šrajk	ˈʃrajk
zadu	ˈzadu
vež	ˈvɛʒ
vyslo	ˈvislɔ
vśak	ˈvak
kostre	ˈkɔstrɛ
šekový	ˈʃɛkɔviː
sedavý	ˈsɛdaviː
slavu	ˈsɫavu
čulo	ˈtʃulɔ
sabove	ˈsabɔvɛ
krachom	ˈkraxɔm
skušal	ˈskuʃal
vyhne	ˈvihnɛ
zvrate	ˈzvratɛ
jump	ˈjump
somarín	ˈsɔmariːn
verny	ˈvɛrni
kunove	ˈkunɔvɛ
safra	ˈsafra
hradný	ˈɦradniː
tvoho	ˈtvɔɦɔ
seco	ˈsɛtsɔ
pozdná	ˈpɔzdnaː
sato	ˈsatɔ
zosadne	ˈzɔsadɲɛ
vatu	ˈvatu
chovalo	ˈxɔvalɔ
strelných	ˈstrɛlniːx
zvolíš	ˈzvɔliːʃ
vedme	ˈvɛdmɛ
zdrbat	ˈzdrbat
hojí	ˈɦɔjiː
kopov	ˈkɔpɔv
poje	ˈpɔjɛ
chou	ˈxɔu
stuňov	ˈstuɲɔv
splu	ˈspɫu
zrovnám	ˈzrɔvnaːm
tvaram	ˈtvaram
výhrad	ˈviːhrad
počulo	ˈpɔtʃulɔ
sanov	ˈsanɔv
santu	ˈsantu
strase	ˈstrasɛ
vrazme	ˈvrazmɛ
sure	ˈsurɛ
tích	ˈtiːx
škrobený	ˈʃkrɔbɛniː
zapojíme	ˈzapɔjiːmɛ
stonal	ˈstɔnal
dara	ˈdara
jasu	ˈjasu
cora	ˈtsɔra
pokusu	ˈpɔkusu
konáru	ˈkɔnaːru
mudro	ˈmudrɔ
vlka	ˈvɫka
zrube	ˈzrubɛ
strun	ˈstrun
znou	ˈznɔu
bona	ˈbɔna
kostele	ˈkɔstɛlɛ
vyholený	ˈvihɔlɛniː
poseru	ˈpɔsɛru
spadnes	ˈspadɲɛs
vosen	ˈvɔsɛn
sambor	ˈsambɔr
zvrane	ˈzvraɲɛ
zversky	ˈzvɛrski
zapísem	ˈzapiːsɛm
vespe	ˈvɛspɛ
duse	ˈdusɛ
koľk	ˈkɔʎk
čok	ˈtʃɔk
vad	ˈvad
pohanka	ˈpɔɦanka
vrak	ˈvrak
víte	ˈviːtɛ
sof	ˈsɔf
krovím	ˈkrɔviːm
traf	ˈtraf
toe	ˈtɔɛ
pasíva	ˈpasiːva
truc	ˈtrut
medom	ˈmɛdɔm
besný	ˈbɛsniː
joël	ˈjɔɫ
slušnou	ˈsɫuʃnɔu
psík	ˈpsiːk
drakov	ˈdrakɔv
skorej	ˈskɔrɛj
kodo	ˈkɔdɔ
zeka	ˈzɛka
vana	ˈvana
stopka	ˈstɔpka
bazuka	ˈbazuka
sankt	ˈsankt
sua	ˈsua
saune	ˈsaunɛ
vyberej	ˈvibɛrɛj
tort	ˈtɔrt
zdravým	ˈzdraviːm
senzus	ˈsɛnzus
vodsa	ˈvɔdsa
kamu	ˈkamu
voru	ˈvɔru
joram	ˈjɔram
bes	ˈbɛs
vyhnem	ˈvihnɛm
výbusný	ˈviːbusniː
sadou	ˈsadɔu
skejt	ˈskɛjt
státě	ˈstɑːt
zmysly	ˈzmisli
vradu	ˈvradu
vetrom	ˈvɛtrɔm
saves	ˈsavɛs
koľaje	ˈkɔʎajɛ
zapotí	ˈzapɔtiː
podlým	ˈpɔdliːm
zabudneš	ˈzabudɲɛʃ
stavky	ˈstavki
kasína	ˈkasiːna
blame	ˈblamɛ
tajna	ˈtajna
bambaataa	ˈbambata
podla	ˈpɔdɫa
poser	ˈpɔsɛr
kurvu	ˈkurvu
zadaný	ˈzadaniː
zebu	ˈzɛbu
maškov	ˈmaʃkɔv
hádka	ˈɦaːdka
zjete	ˈzjɛtɛ
vstupný	ˈvstupniː
podoj	ˈpɔdɔj
soule	ˈsɔulɛ
ceta	ˈtsɛta
moore	ˈmɔrɛ
zonka	ˈzɔnka
koláču	ˈkɔɫaːtʃu
kramo	ˈkramɔ
zajeme	ˈzajɛmɛ
božských	ˈbɔʒskiːx
doru	ˈdɔru
jovu	ˈjɔvu
jebo	ˈjɛbɔ
sloha	ˈsɫɔɦa
znava	ˈznava
kana	ˈkana
vaj	ˈvaj
neumí	ˈɲɛumiː
kept	ˈkɛpt
varí	ˈvariː
zrnd	ˈzrnd
dakým	ˈdakiːm
zdas	ˈzdas
konám	ˈkɔnaːm
vyhoval	ˈvihɔval
zobe	ˈzɔbɛ
peší	ˈpɛʃiː
sotí	ˈsɔtiː
plačeme	ˈpɫatʃɛmɛ
zvalte	ˈzvaltɛ
bezva	ˈbɛzva
dnešny	ˈdɲɛʃni
sadrových	ˈsadrɔviːx
zmeska	ˈzmɛska
neznou	ˈɲɛznɔu
kvan	ˈkvan
pokusím	ˈpɔkusiːm
hodu	ˈɦɔdu
zajka	ˈzajka
beet	ˈbɛt
hase	ˈɦasɛ
skolíte	ˈskɔliːtɛ
spod	ˈspɔd
spot	ˈspɔt
vystupoval	ˈvistupɔval
hrbu	ˈɦrbu
tľap	ˈtʎap
poj	ˈpɔj
časov	ˈtʃasɔv
vrazí	ˈvraziː
jo	ˈjɔ
dbes	ˈdbɛs
hms	ˈɦms
koru	ˈkɔru
spote	ˈspɔtɛ
jow	ˈjɔ
zamotaný	ˈzamɔtaniː
ľude	ˈʎuɟɛ
boomu	ˈbɔmu
skete	ˈskɛtɛ
suke	ˈsukɛ
započul	ˈzapɔtʃul
bomp	ˈbɔmp
pohanat	ˈpɔɦanat
domácka	ˈdɔmaːtska
študuj	ˈʃtuduj
zhabe	ˈzhabɛ
hube	ˈɦubɛ
jaso	ˈjasɔ
dvojake	ˈdvɔjakɛ
predošlí	ˈprɛdɔʃliː
korená	ˈkɔrɛnaː
krensky	ˈkrɛnski
dres	ˈdrɛs
stanoví	ˈstanɔviː
zapata	ˈzapata
vymením	ˈvimɛniːm
hoon	ˈɦɔn
spoorom	ˈspɔrɔm
povedomí	ˈpɔvɛdɔmiː
vynoruje	ˈvinɔrujɛ
dopíš	ˈdɔpiːʃ
kasu	ˈkasu
nepobudneš	ˈɲɛpɔbudɲɛʃ
zástupoch	ˈzaːstupɔx
zmaľoval	ˈzmaʎɔval
zera	ˈzɛra
neškodne	ˈɲɛʃkɔdɲɛ
výhl	ˈviːhl
dvoja	ˈdvɔja
somaľ	ˈsɔmaʎ
dobyje	ˈdɔbijɛ
stamp	ˈstamp
madony	ˈmadɔni
dovere	ˈdɔvɛrɛ
vyša	ˈviʃa
zdobena	ˈzdɔbɛna
pláneta	ˈpɫaːnɛta
zavesíme	ˈzavɛsiːmɛ
pozres	ˈpɔzrɛs
zaba	ˈzaba
vyhrabe	ˈvihrabɛ
šreka	ˈʃrɛka
stoho	ˈstɔɦɔ
susta	ˈsusta
zubu	ˈzubu
barona	ˈbarɔna
beeho	ˈbɛɦɔ
zohna	ˈzɔɦna
torenom	ˈtɔrɛnɔm
vedmu	ˈvɛdmu
vyslov	ˈvislɔv
veký	ˈvɛkiː
sestu	ˈsɛstu
spravaj	ˈspravaj
sušených	ˈsuʃɛniːx
kupes	ˈkupɛs
jalovo	ˈjalɔvɔ
vojakov	ˈvɔjakɔv
ženským	ˈʒɛnskiːm
snom	ˈsnɔm
mocí	ˈmɔtsiː
vykon	ˈvikɔn
vers	ˈvɛrs
zbožnom	ˈzbɔʒnɔm
dvorom	ˈdvɔrɔm
bavu	ˈbavu
zmenku	ˈzmɛnku
koralína	ˈkɔraliːna
zostup	ˈzɔstup
zmesí	ˈzmɛsiː
spácha	ˈspaːxa
stvoríme	ˈstvɔriːmɛ
volno	ˈvɔlnɔ
vamy	ˈvami
zara	ˈzara
šajba	ˈʃajba
nelu	ˈɲɛlu
podlej	ˈpɔdlɛj
stopu	ˈstɔpu
pozro	ˈpɔzrɔ
pods	ˈpɔds
suku	ˈsuku
porazka	ˈpɔrazka
treme	ˈtrɛmɛ
pomerom	ˈpɔmɛrɔm
vežou	ˈvɛʒɔu
vakom	ˈvakɔm
odpo	ˈɔdpɔ
usek	ˈusɛk
zlobu	ˈzɫɔbu
podrobený	ˈpɔdrɔbɛniː
sporo	ˈspɔrɔ
hara	ˈɦara
zorn	ˈzɔrn
svetove	ˈsvɛtɔvɛ
šedých	ˈʃɛdiːx
stráveným	ˈstraːvɛniːm
stope	ˈstɔpɛ
dvs	ˈdvs
cub	ˈtsub
skvalý	ˈskvaliː
nepadne	ˈɲɛpadɲɛ
temne	ˈtɛmnɛ
morový	ˈmɔrɔviː
korých	ˈkɔriːx
medových	ˈmɛdɔviːx
sumo	ˈsumɔ
tvých	ˈtviːx
vyhas	ˈvihas
bantam	ˈbantam
joko	ˈjɔkɔ
pokus	ˈpɔkus
zod	ˈzɔd
trpím	ˈtrpiːm
jonáš	ˈjɔnaːʃ
sabov	ˈsabɔv
žalmy	ˈʒaɫmi
vnemy	ˈvɲɛmi
zajkom	ˈzajkɔm
zapík	ˈzapiːk
suo	ˈsuɔ
madona	ˈmadɔna
moora	ˈmɔra
želaný	ˈʒɛɫaniː
streľa	ˈstrɛʎa
zadus	ˈzadus
krst	ˈkrst
tora	ˈtɔra
cco	ˈtsɔ
strune	ˈstrunɛ
dabs	ˈdabs
súrnu	ˈsuːrnu
vetou	ˈvɛtɔu
korune	ˈkɔrunɛ
vyslovíš	ˈvislɔviːʃ
tojom	ˈtɔjɔm
daru	ˈdaru
budu	ˈbudu
cet	ˈtsɛt
totoje	ˈtɔjɛ
vous	ˈvɔus
uprel	ˈuprɛl
doješ	ˈdɔjɛʃ
poznatok	ˈpɔznatɔk
vľak	ˈvʎak
drek	ˈdrɛk
varený	ˈvarɛniː
stravný	ˈstravniː
slama	ˈsɫama
poletí	ˈpɔlɛtiː
kroch	ˈkrɔx
potkany	ˈpɔtkani
sukromný	ˈsukrɔmniː
zajeb	ˈzajɛb
celu	ˈtsɛlu
katom	ˈkatɔm
doktore	ˈdɔktɔrɛ
žela	ˈʒɛɫa
come	ˈtsɔmɛ
spoločných	ˈspɔɫɔtʃniːx
budnu	ˈbudnu
skromnom	ˈskrɔmnɔm
back	ˈbats
verme	ˈvɛrmɛ
krvný	ˈkrvniː
zostrelený	ˈzɔstrɛlɛniː
namocený	ˈnamɔtsɛniː
výroč	ˈviːrɔt
dbs	ˈdbs
batom	ˈbatɔm
serus	ˈsɛrus
hľadím	ˈɦʎadiːm
stoky	ˈstɔki
srely	ˈsrɛli
jato	ˈjatɔ
vest	ˈvɛst
če	ˈtʃɛ
tambo	ˈtambɔ
beľa	ˈbɛʎa
podkutý	ˈpɔdkutiː
vymenu	ˈvimɛnu
zvodne	ˈzvɔdɲɛ
pozemku	ˈpɔzɛmku
povedte	ˈpɔvɛdtɛ
saj	ˈsaj
nahodí	ˈnaɦɔdiː
jez	ˈjɛz
backy	ˈbatski
výduch	ˈviːdux
sety	ˈsɛti
varena	ˈvarɛna
bonemu	ˈbɔnɛmu
vetrací	ˈvɛtratsiː
vata	ˈvata
zacha	ˈzaxa
toma	ˈtɔma
spoved	ˈspɔvɛd
kých	ˈkiːx
člo	ˈtʃɫɔ
just	ˈjust
vem	ˈvɛm
zotro	ˈzɔtrɔ
kapsu	ˈkapsu
skale	ˈskalɛ
banských	ˈbanskiːx
zlákala	ˈzɫaːka
kusaj	ˈkusaj
moke	ˈmɔkɛ
želatína	ˈʒɛɫatiːna
kosko	ˈkɔskɔ
kvantom	ˈkvantɔm
stonky	ˈstɔnki
zdar	ˈzdar
solný	ˈsɔɫniː
joro	ˈjɔrɔ
zmaloval	ˈzmalɔval
trom	ˈtrɔm
bájna	ˈbaːjna
sacku	ˈsatsku
subor	ˈsubɔr
zdrví	ˈzdrviː
dolej	ˈdɔlɛj
pomstí	ˈpɔmstiː
vzpomen	ˈvzpɔmɛn
plazme	ˈpɫazmɛ
mose	ˈmɔsɛ
zartu	ˈzartu
bojíš	ˈbɔjiːʃ
kostole	ˈkɔstɔlɛ
temu	ˈtɛmu
vaha	ˈvaɦa
bankovým	ˈbankɔviːm
vrecom	ˈvrɛtsɔm
kock	ˈkɔts
vyplač	ˈviplat
podom	ˈpɔdɔm
zatĺka	ˈzatka
zvedaví	ˈzvɛdaviː
čuro	ˈtʃurɔ
safa	ˈsafa
dobra	ˈdɔbra
krajských	ˈkrajskiːx
vśetkom	ˈvɛtkɔm
spajá	ˈspajaː
čestnou	ˈtʃɛstnɔu
dementko	ˈdɛmɛntkɔ
zaratala	ˈzaratala
šeku	ˈʃɛku
žľaboch	ˈʒʎabɔx
tavený	ˈtavɛniː
zloba	ˈzɫɔba
sako	ˈsakɔ
kalna	ˈkaɫna
dorazím	ˈdɔraziːm
vrkoč	ˈvrkɔt
vojstva	ˈvɔjstva
koda	ˈkɔda
vadu	ˈvadu
dvoru	ˈdvɔru
pocítac	ˈpɔtsiːt
nadoru	ˈnadɔru
zlatu	ˈzɫatu
vzatý	ˈvzatiː
svojm	ˈsvɔjm
zha	ˈzha
stupa	ˈstupa
volaš	ˈvɔlɑʃ
domeno	ˈdɔmɛnɔ
slavku	ˈsɫavku
markových	ˈmarkɔviːx
zve	ˈzvɛ
kureta	ˈkurɛta
jams	ˈjams
vatra	ˈvatra
tojo	ˈtɔjɔ
stadu	ˈstadu
doku	ˈdɔku
kompl	ˈkɔmpl
celer	ˈtsɛlɛr
mor	ˈmɔr
sporením	ˈspɔrɛniːm
toľkým	ˈtɔʎkiːm
banskom	ˈbanskɔm
volenka	ˈvɔlɛnka
vra	ˈvra
plavíme	ˈpɫaviːmɛ
daruješ	ˈdarujɛʃ
zkus	ˈzkus
bazový	ˈbazɔviː
spojom	ˈspɔjɔm
vaton	ˈvatɔn
basových	ˈbasɔviːx
pojebaných	ˈpɔjɛbaniːx
koopu	ˈkɔpu
načo	ˈnatʃɔ
sporný	ˈspɔrniː
dotkal	ˈdɔtkal
vlasova	ˈvɫasɔva
kanoka	ˈkanɔka
vleky	ˈvɫɛki
zdobenom	ˈzdɔbɛnɔm
peau	ˈpɛau
slavk	ˈsɫavk
skoda	ˈskɔda
vytlakom	ˈvitɫakɔm
stopom	ˈstɔpɔm
zdroju	ˈzdrɔju
paše	ˈpaʃɛ
sudu	ˈsudu
sune	ˈsunɛ
volu	ˈvɔlu
makový	ˈmakɔviː
bakesa	ˈbakɛsa
zavesím	ˈzavɛsiːm
vazenu	ˈvazɛnu
hors	ˈɦɔrs
kao	ˈkaɔ
postrachom	ˈpɔstraxɔm
boduješ	ˈbɔdujɛʃ
pozrem	ˈpɔzrɛm
sobas	ˈsɔbas
vysaje	ˈvisajɛ
halaa	ˈɦaɫa
seme	ˈsɛmɛ
výskume	ˈviːskumɛ
výhre	ˈviːhrɛ
strap	ˈstrap
spat	ˈspat
zobuj	ˈzɔbuj
drezu	ˈdrɛzu
pakujeme	ˈpakujɛmɛ
vzda	ˈvzda
bavíme	ˈbaviːmɛ
vestou	ˈvɛstɔu
behu	ˈbɛɦu
neľutuje	ˈɲɛʎujɛ
pokusal	ˈpɔkusal
stvora	ˈstvɔra
svetoví	ˈsvɛtɔviː
šrob	ˈʃrɔb
držbe	ˈdrʒbɛ
koe	ˈkɔɛ
soso	ˈsɔsɔ
vyhnaia	ˈvihna
dost	ˈdɔst
dzs	ˈdzs
vymeškal	ˈvimɛʃkal
verou	ˈvɛrɔu
pobavíme	ˈpɔbaviːmɛ
zavrený	ˈzavrɛniː
carron	ˈtsarɔn
háda	ˈɦaːda
čes	ˈtʃɛs
vojensku	ˈvɔjɛnsku
zltej	ˈzɫtɛj
dor	ˈdɔr
spravý	ˈspraviː
spodku	ˈspɔdku
zmyslovej	ˈzmislɔvɛj
kosu	ˈkɔsu
drbe	ˈdrbɛ
bankovku	ˈbankɔvku
skovaný	ˈskɔvaniː
vedomých	ˈvɛdɔmiːx
slavnoj	ˈsɫavnɔj
zveme	ˈzvɛmɛ
bájka	ˈbaːjka
chora	ˈxɔra
zruseny	ˈzrusɛni
skor	ˈskɔr
dracov	ˈdratsɔv
kurvý	ˈkurviː
pozastavený	ˈpɔzastavɛniː
spavat	ˈspavat
chooka	ˈxɔka
spodným	ˈspɔdniːm
kommen	ˈkɔmɛn
vetrone	ˈvɛtrɔnɛ
kľudne	ˈkʎudɲɛ
trepe	ˈtrɛpɛ
spava	ˈspava
dover	ˈdɔvɛr
ted	ˈtɛd
zbavíme	ˈzbaviːmɛ
tvojemu	ˈtvɔjɛmu
skoto	ˈskɔtɔ
mojo	ˈmɔjɔ
prošel	ˈprɔʃɛl
vaším	ˈvaʃiːm
zdravej	ˈzdravɛj
kvíka	ˈkviːka
zapýta	ˈzapiːta
bald	ˈbaɫd
sarou	ˈsarɔu
joe	ˈjɔɛ
ským	ˈskiːm
zdobených	ˈzdɔbɛniːx
tampa	ˈtampa
moj	ˈmɔj
zdobí	ˈzdɔbiː
zosteel	ˈzɔstɛl
skladuje	ˈskladujɛ
zlomí	ˈzɫɔmiː
zdanený	ˈzdaɲɛniː
hoba	ˈɦɔba
zart	ˈzart
pacha	ˈpaxa
sadkaj	ˈsadkaj
zbavení	ˈzbavɛniː
výpek	ˈviːpɛk
vybav	ˈvibav
spola	ˈspɔɫa
pamätame	ˈpamɛtamɛ
doruč	ˈdɔrut
poškrabe	ˈpɔʃkrabɛ
nauč	ˈnaut
zhode	ˈzhɔdɛ
drzos	ˈdrzɔs
tvaroh	ˈtvarɔɦ
topa	ˈtɔpa
dopamín	ˈdɔpamiːn
danka	ˈdanka
žehnáš	ˈʒɛhnaːʃ
skoľ	ˈskɔʎ
kočov	ˈkɔtʃɔv
choďa	ˈxɔɟa
vlast	ˈvɫast
korucu	ˈkɔrutsu
dobreho	ˈdɔbrɛhɔ
kapone	ˈkapɔnɛ
pobudneš	ˈpɔbudɲɛʃ
potkan	ˈpɔtkan
kanou	ˈkanɔu
slave	ˈsɫavɛ
zasmej	ˈzasmɛj
stredového	ˈstrɛdɔvɛːhɔ
zabehaný	ˈzabɛɦaniː
doc	ˈdɔt
beha	ˈbɛɦa
soto	ˈsɔtɔ
bozeman	ˈbɔzɛman
vzručený	ˈvzrutʃɛniː
suší	ˈsuʃiː
mov	ˈmɔv
hrabe	ˈɦrabɛ
splanutí	ˈspɫanutiː
bušenko	ˈbuʃɛnkɔ
šomre	ˈʃɔmrɛ
toľa	ˈtɔʎa
trubíc	ˈtrubiːt
dožíva	ˈdɔʒiːva
vernou	ˈvɛrnɔu
sema	ˈsɛma
drale	ˈdralɛ
drbom	ˈdrbɔm
šachov	ˈʃaxɔv
kodane	ˈkɔdaɲɛ
belka	ˈbɛɫka
zdrbem	ˈzdrbɛm
drem	ˈdrɛm
dobr	ˈdɔbr
udský	ˈudskiː
vysoku	ˈvisɔku
moralesom	ˈmɔralɛsɔm
tore	ˈtɔrɛ
svedsku	ˈsvɛdsku
sume	ˈsumɛ
teho	ˈtɛɦɔ
zožral	ˈzɔʒral
hadov	ˈɦadɔv
tor	ˈtɔr
dune	ˈdunɛ
tod	ˈtɔd
cud	ˈtsud
vzdu	ˈvzdu
stoke	ˈstɔkɛ
výhru	ˈviːhru
zaprí	ˈzapriː
kvák	ˈkvaːk
dolto	ˈdɔɫtɔ
poveste	ˈpɔvɛstɛ
komp	ˈkɔmp
samboru	ˈsambɔru
vasom	ˈvasɔm
dostalo	ˈdɔstɑlɔ
tužím	ˈtuʒiːm
mona	ˈmɔna
zbaví	ˈzbaviː
zjavíš	ˈzjaviːʃ
zreve	ˈzrɛvɛ
komandu	ˈkɔmandu
slaves	ˈsɫavɛs
krorá	ˈkrɔraː
vanom	ˈvanɔm
zlatkom	ˈzɫatkɔm
špata	ˈʃpata
žoho	ˈʒɔɦɔ
dvoje	ˈdvɔjɛ
morb	ˈmɔrb
zlako	ˈzɫakɔ
ńîęđîâčůe	ˈtʃɛ
možmo	ˈmɔʒmɔ
zaleje	ˈzalɛjɛ
vonka	ˈvɔnka
chore	ˈxɔrɛ
toure	ˈtɔurɛ
pozveme	ˈpɔzvɛmɛ
zbohatla	ˈzbɔɦatɫa
sqele	ˈsɛlɛ
kurze	ˈkurzɛ
zamou	ˈzamɔu
krap	ˈkrap
zekov	ˈzɛkɔv
dol	ˈdɔɫ
senor	ˈsɛnɔr
sepu	ˈsɛpu
vezmes	ˈvɛzmɛs
vyhrajeme	ˈvihrajɛmɛ
hombreho	ˈɦɔmbrɛhɔ
strašením	ˈstraʃɛniːm
svom	ˈsvɔm
svetlu	ˈsvɛtɫu
povedzmu	ˈpɔvɛdzmu
sora	ˈsɔra
svojeho	ˈsvɔjɛhɔ
boso	ˈbɔsɔ
výbeh	ˈviːbɛh
poklese	ˈpɔklɛsɛ
tudom	ˈtudɔm
kursk	ˈkursk
čou	ˈtʃɔu
zboku	ˈzbɔku
zosun	ˈzɔsun
nerušíme	ˈɲɛruʃiːmɛ
sušení	ˈsuʃɛniː
drožku	ˈdrɔʒku
časove	ˈtʃasɔvɛ
sebom	ˈsɛbɔm
sampa	ˈsampa
frommer	ˈfrɔmɛr
karen	ˈkarɛn
zdutý	ˈzdutiː
cul	ˈtsul
džajaram	ˈdʒajaram
výr	ˈviːr
kupon	ˈkupɔn
vlajok	ˈvɫajɔk
hava	ˈɦava
kvapku	ˈkvapku
chodu	ˈxɔdu
komanda	ˈkɔmanda
ľadoví	ˈʎadɔviː
vojenskym	ˈvɔjɛnskim
šaha	ˈʃaɦa
zajt	ˈzajt
zverom	ˈzvɛrɔm
vyskumny	ˈviskumni
počkalo	ˈpɔtʃkalɔ
prestona	ˈprɛstɔna
vyplata	ˈviplata
sporu	ˈspɔru
možnos	ˈmɔʒnɔs
busu	ˈbusu
ckl	ˈtskl
harama	ˈɦarama
karom	ˈkarɔm
hana	ˈɦana
nedov	ˈɲɛdɔv
dusíme	ˈdusiːmɛ
spred	ˈsprɛd
baked	ˈbakɛd
slamku	ˈsɫamku
veľku	ˈvɛʎku
podobe	ˈpɔdɔbɛ
suboj	ˈsubɔj
šesto	ˈʃɛstɔ
jahodu	ˈjaɦɔdu
zosuvu	ˈzɔsuvu
toď	ˈtɔɟ
doveruj	ˈdɔvɛruj
vojarov	ˈvɔjarɔv
janou	ˈjanɔu
tlmená	ˈtɫmɛnaː
boland	ˈbɔɫand
vyjav	ˈvijav
zabudam	ˈzabudam
vrtel	ˈvrtɛl
bonusov	ˈbɔnusɔv
tvy	ˈtvi
vykona	ˈvikɔna
bažím	ˈbaʒiːm
cara	ˈtsara
tvoma	ˈtvɔma
zatkla	ˈzatkla
darken	ˈdarkɛn
kusete	ˈkusɛtɛ
výkalov	ˈviːkalɔv
mocha	ˈmɔxa
ľoďku	ˈʎɔɟku
bake	ˈbakɛ
kro	ˈkrɔ
vankuš	ˈvankuʃ
spravy	ˈspravi
močový	ˈmɔtʃɔviː
poznač	ˈpɔznat
nepoď	ˈɲɛpɔɟ
kapucu	ˈkaputsu
duj	ˈduj
vežkos	ˈvɛʒkɔs
družku	ˈdruʒku
taba	ˈtaba
chaka	ˈxaka
špínu	ˈʃpiːnu
vojsku	ˈvɔjsku
zaješ	ˈzajɛʃ
mož	ˈmɔʒ
kame	ˈkamɛ
keze	ˈkɛzɛ
kesa	ˈkɛsa
poserom	ˈpɔsɛrɔm
zrusený	ˈzrusɛniː
temna	ˈtɛmna
sedlom	ˈsɛdɫɔm
podo	ˈpɔdɔ
studs	ˈstuds
sporná	ˈspɔrnaː
tajnom	ˈtajnɔm
vašek	ˈvaʃɛk
banketka	ˈbankɛtka
vzlet	ˈvzɫɛt
buda	ˈbuda
zajete	ˈzajɛtɛ
taja	ˈtaja
zostavíš	ˈzɔstaviːʃ
ser	ˈsɛr
paula	ˈpaula
tajných	ˈtajniːx
zdravých	ˈzdraviːx
zožerme	ˈzɔʒɛrmɛ
zobleč	ˈzɔblɛt
kazy	ˈkazi
pobedz	ˈpɔbɛdz
vado	ˈvadɔ
treer	ˈtrɛr
vyhraný	ˈvihraniː
zbavím	ˈzbaviːm
sober	ˈsɔbɛr
dmuje	ˈdmujɛ
drv	ˈdrv
vezme	ˈvɛzmɛ
zeb	ˈzɛb
satku	ˈsatku
cenou	ˈtsɛnɔu
drobec	ˈdrɔbɛt
tresky	ˈtrɛski
home	ˈɦɔmɛ
jasnou	ˈjasnɔu
bodke	ˈbɔdkɛ
dusíku	ˈdusiːku
korom	ˈkɔrɔm
jeeho	ˈjɛɦɔ
veľný	ˈvɛʎniː
paske	ˈpaskɛ
jocko	ˈjɔtskɔ
vyhraju	ˈvihraju
stredným	ˈstrɛdniːm
dreva	ˈdrɛva
jova	ˈjɔva
corp	ˈtsɔrp
tlame	ˈtɫamɛ
dubs	ˈdubs
suchu	ˈsuxu
zbehla	ˈzbɛɦɫa
celí	ˈtsɛliː
vrátka	ˈvraːtka
spraví	ˈspraviː
machom	ˈmaxɔm
kwo	ˈkɔ
dohod	ˈdɔɦɔd
więc	ˈts
vylež	ˈvilɛʒ
mous	ˈmɔus
mokro	ˈmɔkrɔ
zjemní	ˈzjɛmniː
šekovej	ˈʃɛkɔvɛj
behala	ˈbɛɦaɫa
daton	ˈdatɔn
tvoch	ˈtvɔx
zojst	ˈzɔjst
johna	ˈjɔɦna
znáša	ˈznaːʃa
zomru	ˈzɔmru
vrazíme	ˈvraziːmɛ
zbavíš	ˈzbaviːʃ
tupo	ˈtupɔ
bodu	ˈbɔdu
uzdu	ˈuzdu
hoe	ˈɦɔɛ
paseka	ˈpasɛka
jambo	ˈjambɔ
comb	ˈtsɔmb
kontu	ˈkɔntu
svadu	ˈsvadu
suber	ˈsubɛr
vade	ˈvaɟɛ
choru	ˈxɔru
vyda	ˈvida
zobere	ˈzɔbɛrɛ
bavení	ˈbavɛniː
valu	ˈvalu
kompu	ˈkɔmpu
kaste	ˈkastɛ
veľka	ˈvɛʎka
chodbach	ˈxɔdbax
vyhrab	ˈvihrab
tedom	ˈtɛdɔm
veca	ˈvɛtsa
suš	ˈsuʃ
vykonal	ˈvikɔnal
pohára	ˈpɔɦaːra
vedra	ˈvɛdra
tehot	ˈtɛɦɔt
zapadne	ˈzapadɲɛ
tomb	ˈtɔmb
kuzr	ˈkuzr
šablí	ˈʃabliː
uprace	ˈupratsɛ
šes	ˈʃɛs
slovnu	ˈsɫɔvnu
zlakat	ˈzɫakat
spevak	ˈspɛvak
spojeným	ˈspɔjɛniːm
drum	ˈdrum
zlatka	ˈzɫatka
postrek	ˈpɔstrɛk
zabehla	ˈzabɛɦɫa
bavým	ˈbaviːm
vlajky	ˈvɫajki
veče	ˈvɛtʃɛ
podeme	ˈpɔdɛmɛ
balega	ˈbaɫɛɡa
hadu	ˈɦadu
tupí	ˈtupiː
saver	ˈsavɛr
dojím	ˈdɔjiːm
tabom	ˈtabɔm
koch	ˈkɔx
výkup	ˈviːkup
kusu	ˈkusu
zakryje	ˈzakrijɛ
dork	ˈdɔrk
poznat	ˈpɔznat
buzna	ˈbuzna
poste	ˈpɔstɛ
znaju	ˈznaju
kary	ˈkari
skodu	ˈskɔdu
pomenuj	ˈpɔmɛnuj
vený	ˈvɛniː
stanku	ˈstanku
pecked	ˈpɛtskɛd
zab	ˈzab
cum	ˈtsum
nedocenený	ˈɲɛdɔtsɛniː
semra	ˈsɛmra
znoju	ˈznɔju
tvojem	ˈtvɔjɛm
stonu	ˈstɔnu
zpet	ˈzpɛt
hrajem	ˈɦrajɛm
stropom	ˈstrɔpɔm
carma	ˈtsarma
božska	ˈbɔʒska
sov	ˈsɔv
pokusam	ˈpɔkusam
stavuješ	ˈstavujɛʃ
skapem	ˈskapɛm
vojaka	ˈvɔjaka
sermu	ˈsɛrmu
kýcham	ˈkiːxam
vlej	ˈvɫɛj
tupej	ˈtupɛj
zostruje	ˈzɔstrujɛ
strele	ˈstrɛlɛ
dojnou	ˈdɔjnɔu
cež	ˈtsɛʒ
bezos	ˈbɛzɔs
paste	ˈpastɛ
drnom	ˈdrnɔm
zostreš	ˈzɔstrɛʃ
skuto	ˈskutɔ
ľadovec	ˈʎadɔvɛt
kotve	ˈkɔtvɛ
hoou	ˈɦɔu
verna	ˈvɛrna
moka	ˈmɔka
koval	ˈkɔval
posekaj	ˈpɔsɛkaj
volný	ˈvɔlniː
kedý	ˈkɛdiː
skýva	ˈskiːva
vstupným	ˈvstupniːm
skurv	ˈskurv
zebre	ˈzɛbrɛ
vaší	ˈvaʃiː
haward	ˈɦard
mony	ˈmɔni
strednu	ˈstrɛdnu
koľa	ˈkɔʎa
zastavíme	ˈzastaviːmɛ
smeč	ˈsmɛt
varíme	ˈvariːmɛ
zátvorka	ˈzaːtvɔrka
dusný	ˈdusniː
dopraví	ˈdɔpraviː
spravým	ˈspraviːm
zvadov	ˈzvadɔv
cajka	ˈtsajka
daretu	ˈdarɛtu
sacha	ˈsaxa
výbrus	ˈviːbrus
streľné	ˈstrɛʎnɛː
strav	ˈstrav
tomma	ˈtɔma
pomalej	ˈpɔmalɛj
sodným	ˈsɔdniːm
spýta	ˈspiːta
zborí	ˈzbɔriː
stanovím	ˈstanɔviːm
zostrel	ˈzɔstrɛl
boja	ˈbɔja
škrobu	ˈʃkrɔbu
skromná	ˈskrɔmnaː
vykazuje	ˈvikazujɛ
správna	ˈspraːvna
sao	ˈsaɔ
povýšení	ˈpɔviːʃɛniː
zrnku	ˈzrnku
vankom	ˈvankɔm
zlomíš	ˈzɫɔmiːʃ
kakarota	ˈkarɔta
prekonalo	ˈprɛkɔnalɔ
konaný	ˈkɔnaniː
pozname	ˈpɔznamɛ
bujuješ	ˈbujɛʃ
saša	ˈsaʃa
zabrat	ˈzabrat
čuj	ˈtʃuj
vrkoch	ˈvrkɔx
pastelku	ˈpastɛlku
dnesk	ˈdɲɛsk
voleja	ˈvɔlɛja
stredny	ˈstrɛdni
pojebaným	ˈpɔjɛbaniːm
dravec	ˈdravɛt
stajlovať	ˈstajlɔvaθ
pocuj	ˈpɔtsuj
dotuje	ˈdɔtujɛ
sojho	ˈsɔjhɔ
bana	ˈbana
kramera	ˈkramɛra
zlobe	ˈzɫɔbɛ
doska	ˈdɔska
dvorak	ˈdvɔrak
sond	ˈsɔnd
kolená	ˈkɔlɛnaː
dabu	ˈdabu
tabe	ˈtabɛ
sochu	ˈsɔxu
move	ˈmɔvɛ
dopravený	ˈdɔpravɛniː
stopový	ˈstɔpɔviː
buse	ˈbusɛ
zľave	ˈzʎavɛ
zostalo	ˈzɔstɑlɔ
prosení	ˈprɔsɛniː
ddos	ˈdɔs
koja	ˈkɔja
kuvajtu	ˈkuvajtu
kravka	ˈkravka
morušové	ˈmɔruʃɔvɛː
zveruješ	ˈzvɛrujɛʃ
smre	ˈsmrɛ
stranova	ˈstranɔva
toj	ˈtɔj
streľných	ˈstrɛʎniːx
pobavíš	ˈpɔbaviːʃ
poves	ˈpɔvɛs
zboroch	ˈzbɔrɔx
vranou	ˈvranɔu
seton	ˈsɛtɔn
joh	ˈjɔɦ
strand	ˈstrand
buhe	ˈbuɦɛ
krvý	ˈkrviː
župam	ˈʒupam
vyboru	ˈvibɔru
časí	ˈtʃasiː
vydal	ˈvidal
dowda	ˈdɔda
šero	ˈʃɛrɔ
poseľ	ˈpɔsɛʎ
zomreš	ˈzɔmrɛʃ
moču	ˈmɔtʃu
pozostaval	ˈpɔzɔstɑval
zrelí	ˈzrɛliː
spolku	ˈspɔɫku
vyhrava	ˈvihrava
vyse	ˈvisɛ
stranda	ˈstranda
tamvý	ˈtamviː
zmesku	ˈzmɛsku
dresu	ˈdrɛsu
vedomím	ˈvɛdɔmiːm
dražbu	ˈdraʒbu
sľube	ˈsʎubɛ
dvorec	ˈdvɔrɛt
sadrový	ˈsadrɔviː
plastu	ˈpɫastu
suds	ˈsuds
vreska	ˈvrɛska
skryj	ˈskrij
stanovu	ˈstanɔvu
zlahka	ˈzɫaɦka
bema	ˈbɛma
kup	ˈkup
kresle	ˈkrɛslɛ
doľava	ˈdɔʎava
skautu	ˈskautu
solo	ˈsɔɫɔ
soho	ˈsɔɦɔ
vyjeb	ˈvijɛb
zosadneš	ˈzɔsadɲɛʃ
ujalo	ˈujalɔ
zork	ˈzɔrk
zltom	ˈzɫtɔm
výstupe	ˈviːstupɛ
sarku	ˈsarku
jojom	ˈjɔm
sporom	ˈspɔrɔm
novším	ˈnɔvʃiːm
teu	ˈtɛu
jahee	ˈjaɦɛ
dvore	ˈdvɔrɛ
justo	ˈjustɔ
kurve	ˈkurvɛ
vzore	ˈvzɔrɛ
želaj	ˈʒɛɫaj
samanta	ˈsamanta
vyhral	ˈvihral
strave	ˈstravɛ
vadou	ˈvadɔu
js	ˈjs
vecy	ˈvɛtsi
bauma	ˈbauma
hanou	ˈɦanɔu
bachov	ˈbaxɔv
domových	ˈdɔmɔviːx
čos	ˈtʃɔs
kýcha	ˈkiːxa
poznatkom	ˈpɔznatkɔm
baroneta	ˈbarɔnɛta
doble	ˈdɔblɛ
baštu	ˈbaʃtu
speck	ˈspɛts
čej	ˈtʃɛj
postrehom	ˈpɔstrɛhɔm
vráska	ˈvraːska
bosk	ˈbɔsk
cut	ˈtsut
vermus	ˈvɛrmus
domku	ˈdɔmku
sumraku	ˈsumraku
modráča	ˈmɔdraːtʃa
tap	ˈtap
šopu	ˈʃɔpu
bumbác	ˈbumbaːt
zapla	ˈzapɫa
doveru	ˈdɔvɛru
baka	ˈbaka
pobavený	ˈpɔbavɛniː
paze	ˈpazɛ
vzletu	ˈvzɫɛtu
zasral	ˈzasral
možnou	ˈmɔʒnɔu
monako	ˈmɔnakɔ
poslo	ˈpɔsɫɔ
dopr	ˈdɔpr
ctx	ˈtst
vredom	ˈvrɛdɔm
škrob	ˈʃkrɔb
karmu	ˈkarmu
donosí	ˈdɔnɔsiː
zapíše	ˈzapiːʃɛ
dresom	ˈdrɛsɔm
spak	ˈspak
zru	ˈzru
zrn	ˈzrn
trojan	ˈtrɔjan
poznavame	ˈpɔznavamɛ
koleso	ˈkɔlɛsɔ
senora	ˈsɛnɔra
topov	ˈtɔpɔv
koro	ˈkɔrɔ
veeru	ˈvɛru
vedomí	ˈvɛdɔmiː
zoru	ˈzɔru
vložku	ˈvɫɔʒku
zakladný	ˈzakladniː
kostoly	ˈkɔstɔli
skape	ˈskapɛ
prestaval	ˈprɛstaval
zvedom	ˈzvɛdɔm
prelomový	ˈprɛlɔmɔviː
druch	ˈdrux
zvrtol	ˈzvrtɔl
bandu	ˈbandu
potele	ˈpɔtɛlɛ
vláčený	ˈvɫaːtʃɛniː
každýmu	ˈkaʒdiːmu
dorn	ˈdɔrn
hano	ˈɦanɔ
bazís	ˈbaziːs
sojím	ˈsɔjiːm
smešny	ˈsmɛʃni
bandov	ˈbandɔv
stank	ˈstank
stopa	ˈstɔpa
zbaň	ˈzbaɲ
zus	ˈzus
zasun	ˈzasun
muhe	ˈmuɦɛ
kapec	ˈkapɛt
posera	ˈpɔsɛra
držba	ˈdrʒba
šokový	ˈʃɔkɔviː
ľadom	ˈʎadɔm
vyhralo	ˈvihralɔ
zmorený	ˈzmɔrɛniː
poznavam	ˈpɔznavam
volí	ˈvɔliː
sašenku	ˈsaʃɛnku
prestalo	ˈprɛstalɔ
hooda	ˈɦɔda
kvou	ˈkvɔu
stanou	ˈstanɔu
sakel	ˈsakɛl
vyberat	ˈvibɛrat
sudoku	ˈsudɔku
podel	ˈpɔdɛl
pause	ˈpausɛ
seth	ˈsɛtɦ
zaves	ˈzavɛs
sazku	ˈsazku
zmetok	ˈzmɛtɔk
konára	ˈkɔnaːra
zvaľuje	ˈzvaʎujɛ
hamo	ˈɦamɔ
tlama	ˈtɫama
soma	ˈsɔma
dru	ˈdru
žuje	ˈʒujɛ
nepadnem	ˈɲɛpadɲɛm
vyser	ˈvisɛr
horn	ˈɦɔrn
setha	ˈsɛtɦa
veraje	ˈvɛrajɛ
demat	ˈdɛmat
voľbe	ˈvɔʎbɛ
vychova	ˈvixɔva
behe	ˈbɛɦɛ
pastva	ˈpastva
povevedzme	ˈpɔvɛdzmɛ
neuk	ˈɲɛuk
sprejuje	ˈsprɛjujɛ
zatĺkal	ˈzatkal
caj	ˈtsaj
past	ˈpast
sudo	ˈsudɔ
karma	ˈkarma
hrdom	ˈɦrdɔm
pubis	ˈpubis
padlých	ˈpadliːx
bavlna	ˈbavɫna
tobe	ˈtɔbɛ
bosu	ˈbɔsu
konalo	ˈkɔnalɔ
kemp	ˈkɛmp
vlnach	ˈvɫnax
traju	ˈtraju
dubu	ˈdubu
sene	ˈsɛnɛ
kuslo	ˈkusɫɔ
vyšej	ˈviʃɛj
zboj	ˈzbɔj
vylet	ˈvilɛt
verají	ˈvɛrajiː
mrkový	ˈmrkɔviː
večnom	ˈvɛtʃnɔm
vasemu	ˈvasɛmu
domo	ˈdɔmɔ
značí	ˈznatʃiː
javo	ˈjavɔ
vzdal	ˈvzdal
výroku	ˈviːrɔku
vlame	ˈvɫamɛ
poznatku	ˈpɔznatku
savo	ˈsavɔ
tempu	ˈtɛmpu
božským	ˈbɔʒskiːm
corny	ˈtsɔrni
presune	ˈprɛsunɛ
kaameň	ˈkamɛɲ
caka	ˈtsaka
vreckových	ˈvrɛtskɔviːx
baala	ˈbaɫa
naroda	ˈnarɔda
domos	ˈdɔmɔs
tme	ˈtmɛ
kore	ˈkɔrɛ
naudúce	ˈnauduːtsɛ
spoň	ˈspɔɲ
čosa	ˈtʃɔsa
sethe	ˈsɛtɦɛ
corn	ˈtsɔrn
pozícou	ˈpɔziːtsɔu
hasím	ˈɦasiːm
vnára	ˈvnaːra
vrma	ˈvrma
zastre	ˈzastrɛ
kryhe	ˈkrihɛ
jaro	ˈjarɔ
sub	ˈsub
varím	ˈvariːm
moha	ˈmɔɦa
cam	ˈtsam
poznamku	ˈpɔznamku
strešná	ˈstrɛʃnaː
damona	ˈdamɔna
sobom	ˈsɔbɔm
zabuchla	ˈzabuxla
zamora	ˈzamɔra
vzpomeň	ˈvzpɔmɛɲ
zasko	ˈzaskɔ
vote	ˈvɔtɛ
cert	ˈtsɛrt
kop	ˈkɔp
pasa	ˈpasa
koon	ˈkɔn
stupaju	ˈstupaju
žeravej	ˈʒɛravɛj
bala	ˈbaɫa
carova	ˈtsarɔva
zomna	ˈzɔmna
zrnom	ˈzrnɔm
postom	ˈpɔstɔm
spodne	ˈspɔdɲɛ
zotrel	ˈzɔtrɛl
bojar	ˈbɔjar
topí	ˈtɔpiː
čka	ˈtʃka
stehom	ˈstɛhɔm
varíš	ˈvariːʃ
kudu	ˈkudu
chána	ˈxaːna
peších	ˈpɛʃiːx
pest	ˈpɛst
vystraším	ˈvistraʃiːm
kamer	ˈkamɛr
pozrelo	ˈpɔzrɛlɔ
padnutá	ˈpadnutaː
tvovom	ˈtvɔm
zom	ˈzɔm
vymenoval	ˈvimɛnɔval
sunku	ˈsunku
kamo	ˈkamɔ
zuba	ˈzuba
zodrel	ˈzɔdrɛl
coner	ˈtsɔnɛr
pestí	ˈpɛstiː
veľmy	ˈvɛʎmi
manova	ˈmanɔva
vrtule	ˈvrtulɛ
dopo	ˈdɔpɔ
padla	ˈpadɫa
vyklad	ˈviklad
savím	ˈsaviːm
zosuve	ˈzɔsuvɛ
spojím	ˈspɔjiːm
daze	ˈdazɛ
tja	ˈtja
zástupný	ˈzaːstupniː
poľavíš	ˈpɔʎaviːʃ
korna	ˈkɔrna
sektore	ˈsɛktɔrɛ
číje	ˈtʃiːjɛ
vlkoch	ˈvɫkɔx
skora	ˈskɔra
strelku	ˈstrɛlku
pozemná	ˈpɔzɛmnaː
zadný	ˈzadniː
kremeľ	ˈkrɛmɛʎ
stavým	ˈstaviːm
hodno	ˈɦɔdnɔ
hood	ˈɦɔd
chapík	ˈxapiːk
volne	ˈvɔlɲɛ
čul	ˈtʃul
štople	ˈʃtɔplɛ
baus	ˈbaus
sošku	ˈsɔʃku
zletí	ˈzɫɛtiː
peste	ˈpɛstɛ
pozemkov	ˈpɔzɛmkɔv
modna	ˈmɔdna
volaný	ˈvɔlɑniː
cant	ˈtsant
sladu	ˈsɫadu
tapeta	ˈtapɛta
poznáva	ˈpɔznaːva
valím	ˈvaliːm
skoru	ˈskɔru
kono	ˈkɔnɔ
beloška	ˈbɛɫɔʃka
volkov	ˈvɔlkɔv
pojebe	ˈpɔjɛbɛ
dolar	ˈdɔɫar
stravu	ˈstravu
kosele	ˈkɔsɛlɛ
krysej	ˈkrisɛj
pestuj	ˈpɛstuj
kapra	ˈkapra
newest	ˈɲɛst
katonah	ˈkatɔnaɦ
skromne	ˈskrɔmnɛ
plaze	ˈpɫazɛ
hasn	ˈɦasn
zdravo	ˈzdravɔ
dražba	ˈdraʒba
troly	ˈtrɔli
odola	ˈɔdɔɫa
zdrvená	ˈzdrvɛnaː
jon	ˈjɔn
zákaze	ˈzaːkazɛ
vyhol	ˈvihɔl
sponku	ˈspɔnku
frajera	ˈfrajɛra
tohe	ˈtɔɦɛ
vypat	ˈvipat
krach	ˈkrax
budz	ˈbudz
sporným	ˈspɔrniːm
bondu	ˈbɔndu
zvysoka	ˈzvisɔka
coura	ˈtsɔura
výsad	ˈviːsad
sádra	ˈsaːdra
habe	ˈɦabɛ
stanok	ˈstanɔk
stajna	ˈstajna
veslo	ˈvɛsɫɔ
kunom	ˈkunɔm
stupna	ˈstupna
menace	ˈmɛnatsɛ
sudom	ˈsudɔm
dabra	ˈdabra
dotor	ˈdɔtɔr
tvarom	ˈtvarɔm
saruba	ˈsaruba
kely	ˈkɛli
skvelí	ˈskvɛliː
varuje	ˈvarujɛ
vzdam	ˈvzdam
torý	ˈtɔriː
jeba	ˈjɛba
dopíšem	ˈdɔpiːʃɛm
suze	ˈsuzɛ
valíme	ˈvaliːmɛ
podeste	ˈpɔdɛstɛ
vypaseným	ˈvipasɛniːm
ktomu	ˈktɔmu
vaľa	ˈvaʎa
džala	ˈdʒaɫa
veže	ˈvɛʒɛ
vletom	ˈvɫɛtɔm
doko	ˈdɔkɔ
kajutou	ˈkajutɔu
beezus	ˈbɛzus
telpý	ˈtɛlpiː
smer	ˈsmɛr
pojeba	ˈpɔjɛba
zatím	ˈzatiːm
koos	ˈkɔs
docka	ˈdɔtska
trosky	ˈtrɔski
čekat	ˈtʃɛkat
kusom	ˈkusɔm
stopku	ˈstɔpku
preston	ˈprɛstɔn
buds	ˈbuds
sum	ˈsum
skaara	ˈskara
kase	ˈkasɛ
zľavový	ˈzʎavɔviː
noša	ˈnɔʃa
pohla	ˈpɔɦɫa
barom	ˈbarɔm
vyslový	ˈvislɔviː
kudo	ˈkudɔ
výtvore	ˈviːtvɔrɛ
zberný	ˈzbɛrniː
moskvu	ˈmɔskvu
kou	ˈkɔu
tvojí	ˈtvɔjiː
bodne	ˈbɔdɲɛ
kodu	ˈkɔdu
verklík	ˈvɛrkliːk
vysoka	ˈvisɔka
zloduch	ˈzɫɔdux
seru	ˈsɛru
zabu	ˈzabu
horst	ˈɦɔrst
moru	ˈmɔru
stavam	ˈstavam
toja	ˈtɔja
spávna	ˈspaːvna
vydame	ˈvidamɛ
wcko	ˈtskɔ
postavý	ˈpɔstaviː
šah	ˈʃaɦ
kuna	ˈkuna
tosu	ˈtɔsu
dojí	ˈdɔjiː
zlachka	ˈzɫaxka
vekovom	ˈvɛkɔm
strašnom	ˈstraʃnɔm
vase	ˈvasɛ
vesla	ˈvɛsɫa
hado	ˈɦadɔ
kona	ˈkɔna
hast	ˈɦast
sprav	ˈsprav
zbernom	ˈzbɛrnɔm
zostra	ˈzɔstra
suse	ˈsusɛ
zmeškaných	ˈzmɛʃkaniːx
studom	ˈstudɔm
zbav	ˈzbav
spratok	ˈspratɔk
zves	ˈzvɛs
morke	ˈmɔrkɛ
donáška	ˈdɔnaːʃka
vod	ˈvɔd
kopec	ˈkɔpɛt
škode	ˈʃkɔdɛ
pošľem	ˈpɔʃʎɛm
sanova	ˈsanɔva
vyhodme	ˈvihɔdmɛ
sebu	ˈsɛbu
zjem	ˈzjɛm
stand	ˈstand
ponáša	ˈpɔnaːʃa
dojebe	ˈdɔjɛbɛ
nohach	ˈnɔɦax
družbu	ˈdruʒbu
sadnu	ˈsadnu
džemuje	ˈdʒɛmujɛ
vladat	ˈvɫadat
ston	ˈstɔn
dorast	ˈdɔrast
stravenku	ˈstravɛnku
zmyslov	ˈzmislɔv
nahodu	ˈnaɦɔdu
vlakov	ˈvɫakɔv
hýb	ˈɦiːb
stupu	ˈstupu
voju	ˈvɔju
sallyina	ˈsalina
volny	ˈvɔlni
šepkandu	ˈʃɛpkandu
tebu	ˈtɛbu
sabo	ˈsabɔ
dojst	ˈdɔjst
zoro	ˈzɔrɔ
stropný	ˈstrɔpniː
dusk	ˈdusk
baňou	ˈbaɲɔu
orbu	ˈɔrbu
vlož	ˈvɫɔʒ
doručenku	ˈdɔrutʃɛnku
sambor	ˈsambɔr
špiceľ	ˈʃpitsɛʎ
ostrekovať	ˈɔstrɛkɔvaθ
frontách	ˈfrɔntaːx
dik	ˈɟik
vykročím	ˈvikrɔtʃiːm
škuľavé	ˈʃkuʎavɛː
zveličujem	ˈzvɛlitʃujɛm
hura	ˈɦura
bratr	ˈbratr
kurcinál	ˈkurtsinaːɫ
stabilným	ˈstabilniːm
labami	ˈɫabami
japnska	ˈjapnska
vykľula	ˈvikʎula
neprekážajú	ˈɲɛprɛkaːʒajuː
dialóg	ˈɟiaɫɔːɡ
kolumbovi	ˈkɔlumbɔvi
vitazom	ˈvitɑzɔm
záslužná	ˈzaːsluʒnaː
pocestní	ˈpɔtsɛstniː
paulína	ˈpauliːna
dáka	ˈdaːka
klesajúcej	ˈklɛsajuːtsɛj
crispa	ˈtsrispa
espiat	ˈɛspiat
opálenou	ˈɔpaːlɛnɔu
vincentov	ˈvintsɛntɔv
kuka	ˈkuka
krátký	ˈkraːtkiː
národnou	ˈnaːrɔdnɔu
čudlík	ˈtʃudliːk
rockujem	ˈrɔtskujɛm
pochádzajúca	ˈpɔxaːdzajuːtsa
spoločenskom	ˈspɔɫɔtʃɛnskɔm
blazon	ˈbɫazɔn
meraniami	ˈmɛraɲiami
hb	ˈɦb
bisťu	ˈbisθu
mentora	ˈmɛntɔra
orientciu	ˈɔriɛntsiu
plauta	ˈpɫauta
merá	ˈmɛraː
farmer	ˈfarmɛr
knedle	ˈkɲɛdlɛ
mertovi	ˈmɛrtɔvi
nedozvedela	ˈɲɛdɔzvɛɟɛlɑ
omeškanci	ˈɔmɛʃkantsi
vincom	ˈvintsɔm
wobec	ˈvɔbɛt
brm	ˈbrm
odprac	ˈɔdprat
nepočulo	ˈɲɛpɔtʃulɔ
bublinách	ˈbublinaːx
vzniknú	ˈvzɲiknuː
rajos	ˈrajɔs
picking	ˈpitskinɡ
krizovy	ˈkrizɔvi
bradavkami	ˈbradavkami
oscaroch	ˈɔstsarɔx
pokyny	ˈpɔkini
čávovia	ˈtʃaːvɔvia
gumova	ˈɡumɔva
vyzenieme	ˈvizɛɲiɛm
stovkami	ˈstɔvkami
whisper	ˈvispɛr
pytač	ˈpitat
harbim	ˈɦarbim
hosni	ˈɦɔsɲi
októbera	ˈɔktɔːbɛra
nespôsob	ˈɲɛspuɔsɔb
obrovskí	ˈɔbrɔvskiː
mynulú	ˈminuɫuː
robim	ˈrɔbim
jill	ˈjil
rúhať	ˈruːɦaθ
margit	ˈmarɡit
rozširovala	ˈrɔzʃirɔvalɑ
saku	ˈsaku
mutt	ˈmut
lyžiarov	ˈliʒiarɔv
sračkou	ˈsratʃkɔu
vrtochy	ˈvrtɔxi
dolezitom	ˈdɔlɛzitɔm
šialenstvom	ˈʃialɛnstvɔm
tojomstvo	ˈtɔjɔmstvɔ
kakáč	ˈkakaːt
hyah	ˈɦiaɦ
rozobrané	ˈrɔzɔbrɑnɛː
armstrong	ˈarmstrɔnɡ
tád	ˈtɑːd
mieni	ˈmiɛɲi
nezaradí	ˈɲɛzaraɟiː
balvanom	ˈbaɫvanɔm
hriešnych	ˈɦriɛʃnix
neskúšajú	ˈɲɛskuːʃajuː
okradneš	ˈɔkradɲɛʃ
križa	ˈkriʒa
casov	ˈtsasɔv
rámca	ˈraːmtsa
egyptsky	ˈɛɡiptski
bonna	ˈbɔna
burdona	ˈburdɔna
bicykly	ˈbitsikli
miners	ˈminɛrs
ryje	ˈrijɛ
základy	ˈzaːkladi
zhovárala	ˈzhɔvɑːralɑ
nehybat	ˈɲɛɦibat
zahovorím	ˈzaɦɔvɔriːm
antonom	ˈantɔnɔm
rozčuluješ	ˈrɔztʃulujɛʃ
čarovať	ˈtʃarɔvaθ
nepokradla	ˈɲɛpɔkradɫa
píliť	ˈpiːliθ
bojarmi	ˈbɔjarmi
washom	ˈvashɔm
bikos	ˈbikɔs
investuj	ˈinvɛstuj
náboženskom	ˈnaːbɔʒɛnskɔm
nature	ˈnaturɛ
kontroľujú	ˈkɔntrɔʎujuː
podbruškom	ˈpɔdbruʃkɔm
počkej	ˈpɔtʃkɛj
núka	ˈnuːka
nenarobím	ˈɲɛnarɔbiːm
foxovej	ˈfɔksɔvɛj
smozrejme	ˈsmɔzrɛjmɛ
spravim	ˈspravim
sobeckým	ˈsɔbɛtskiːm
môjim	ˈmuɔjim
zabávkať	ˈzabaːvkaθ
gruzínska	ˈɡruziːnska
zmysloch	ˈzmislɔx
hijacks	ˈɦijatsk
vylepším	ˈvilɛpʃiːm
vyhnanec	ˈvihnaɲɛt
lobovala	ˈɫɔbɔvalɑ
tropic	ˈtrɔpit
vyčerpajú	ˈvitʃɛrpajuː
aker	ˈakɛr
camera	ˈtsamɛra
podceníš	ˈpɔdtsɛɲiːʃ
napomínaš	ˈnapɔmiːnaʃ
pokrovym	ˈpɔkrɔvim
vyučko	ˈviutʃkɔ
cesna	ˈtsɛsna
zvonár	ˈzvɔnaːr
opatrovateľky	ˈɔpatrɔvaθɛʎki
osmond	ˈɔsmɔnd
peeping	ˈpɛpinɡ
callen	ˈtsalɛn
chóra	ˈxɔːra
posiluješ	ˈpɔsilujɛʃ
vyfajč	ˈvifajt
paškál	ˈpaʃkaːɫ
hobbes	ˈɦɔbɛs
národy	ˈnaːrɔdi
jobom	ˈjɔbɔm
pokonajúci	ˈpɔkɔnajuːtsi
zdovolením	ˈzdɔvɔlɛɲiːm
kopnem	ˈkɔpɲɛm
termitu	ˈtɛrmitu
sekundový	ˈsɛkundɔviː
vyznamnej	ˈviznamɲɛj
bráško	ˈbraːʃkɔ
blíska	ˈbliːska
zakrylo	ˈzakrilɔ
lemont	ˈlɛmɔnt
diet	ˈɟiɛt
odpalovacie	ˈɔdpalɔvatsiɛ
bratoch	ˈbratɔx
rybou	ˈribɔu
desili	ˈɟɛsili
bakes	ˈbakɛs
barber	ˈbarbɛr
tia	ˈtia
frázach	ˈfraːzax
zatýkali	ˈzatiːkali
murom	ˈmurɔm
štastím	ˈʃtasθiːm
čistoty	ˈtʃistɔti
maher	ˈmaɦɛr
rocny	ˈrɔtsni
wiglaf	ˈviɡlaf
keksíky	ˈkɛksiːki
radim	ˈraɟim
nevozia	ˈɲɛvɔzia
kúrie	ˈkuːriɛ
výskyt	ˈviːskit
vyvádzať	ˈvivɑːdzaθ
aktívnym	ˈaktiːvnim
mysliteľmi	ˈmisliθɛʎmi
poruč	ˈpɔrut
netúžiš	ˈɲɛtuːʒiʃ
banánmi	ˈbanaːmi
uzit	ˈuzit
neumývaj	ˈɲɛumiːvaj
overujem	ˈɔvɛrujɛm
záložnou	ˈzaːlɔʒnɔu
nivert	ˈɲivɛrt
okolitom	ˈɔkɔlitɔm
budúcoročnom	ˈbuduːtsɔrɔtʃnɔm
johnovým	ˈjɔɦnɔviːm
hybal	ˈɦibaɫ
podrobení	ˈpɔdrɔbɛɲiː
spek	ˈspɛk
výhrať	ˈviːhraθ
terasu	ˈtɛrasu
laputou	ˈɫaputɔu
surová	ˈsurɔvaː
ukláňať	ˈuklaːɲaθ
dolina	ˈdɔlina
nakúpim	ˈnakuːpim
ochraňujte	ˈɔxraɲujθɛ
osobám	ˈɔsɔbaːm
deagest	ˈdɛaɡɛst
napili	ˈnapili
dvorením	ˈdvɔrɛɲiːm
neuk	ˈɲɛuk
sprchy	ˈsprxi
kolieskovú	ˈkɔliɛskɔvuː
flops	ˈfɫɔps
patológ	ˈpatɔɫɔːɡ
afis	ˈafis
dvoják	ˈdvɔjaːk
šmahom	ˈʃmaɦɔm
poži	ˈpɔʒi
vyjadrenim	ˈvijadrɛɲim
myrna	ˈmirna
oves	ˈɔvɛs
ženúci	ˈʒɛnuːtsi
bezbožná	ˈbɛzbɔʒnaː
dukliansky	ˈduklianski
necudné	ˈɲɛtsudnɛː
tovieš	ˈtɔviɛʃ
archiv	ˈarxiv
normálneho	ˈnɔrmaːlɲɛhɔ
klientov	ˈkliɛntɔv
bacilov	ˈbatsilɔv
slow	ˈsɫɔv
ľavoboku	ˈʎavɔbɔku
nevyštím	ˈɲɛviʃθiːm
ijem	ˈijɛm
pečiatku	ˈpɛtʃiatku
karlove	ˈkarlɔvɛ
sandáloch	ˈsandaːɫɔx
poučovanie	ˈpɔutʃɔvaɲiɛ
spät	ˈspæt
nezdržoval	ˈɲɛzdrʒɔval
stačia	ˈstatʃia
odsekol	ˈɔdsɛkɔɫ
skort	ˈskɔrt
zákroky	ˈzaːkrɔki
grenada	ˈɡrɛnada
spácham	ˈspaːxam
spustit	ˈspusθit
pikové	ˈpikɔvɛː
jool	ˈjɔɫ
červeným	ˈtʃɛrvɛniːm
pomeril	ˈpɔmɛril
podvoliť	ˈpɔdvɔliθ
namiešam	ˈnamiɛʃam
žravej	ˈʒravɛj
stokou	ˈstɔkɔu
piča	ˈpitʃa
neberiš	ˈɲɛbɛriʃ
poňho	ˈpɔɲɦɔ
nalákaj	ˈnaɫaːkaj
watersovú	ˈvatɛrsɔvuː
cadmus	ˈtsadmus
pohrebnou	ˈpɔɦrɛbnɔu
woolen	ˈvɔlɛn
tuzi	ˈtuzi
búrky	ˈbuːrki
ovčom	ˈɔvtʃɔm
žiaci	ˈʒiɑtsi
rozkazujú	ˈrɔzkazujuː
pozdávajú	ˈpɔzdaːvajuː
dovernu	ˈdɔvɛrnu
pečaťou	ˈpɛtʃaθɔu
cvičil	ˈtsvitʃil
množstva	ˈmnɔʒstva
flákam	ˈfɫaːkam
púzdra	ˈpuːzdra
výčitok	ˈviːtʃitɔk
mušľami	ˈmuʃʎami
poklona	ˈpɔklɔna
múdrost	ˈmuːdrɔst
končim	ˈkɔntʃim
dozrievajú	ˈdɔzriɛvajuː
kubansky	ˈkubanski
pursang	ˈpursanɡ
policajtom	ˈpɔlitsajtɔm
šupneš	ˈʃupɲɛʃ
nazývam	ˈnaziːvam
ochabnuto	ˈɔxabnutɔ
nástup	ˈnaːstup
nevábnym	ˈɲɛvaːbnim
lamami	ˈɫamami
